month,year,full_time,part_time,grand_total,carrier
1,2004,1717,492,2209,9E
2,2004,1748,486,2234,9E
3,2004,1766,462,2228,9E
4,2004,1827,457,2284,9E
5,2004,1913,487,2400,9E
6,2004,1966,511,2477,9E
7,2004,1957,614,2571,9E
8,2004,1948,710,2658,9E
9,2004,2010,816,2826,9E
10,2004,2054,867,2921,9E
11,2004,2098,912,3010,9E
12,2004,2154,902,3056,9E
1,2005,2150,947,3097,9E
2,2005,2244,1018,3262,9E
3,2005,2315,1035,3350,9E
4,2005,2371,1041,3412,9E
5,2005,2459,1009,3468,9E
6,2005,2539,1025,3564,9E
7,2005,2542,1057,3599,9E
8,2005,2568,1052,3620,9E
9,2005,2555,1050,3605,9E
10,2005,2506,1001,3507,9E
11,2005,2495,953,3448,9E
12,2005,2500,936,3436,9E
1,2006,2482,961,3443,9E
2,2006,2509,963,3472,9E
3,2006,2530,1018,3548,9E
4,2006,2521,1031,3552,9E
5,2006,2486,1038,3524,9E
6,2006,2531,1036,3567,9E
7,2006,2537,1022,3559,9E
8,2006,2552,997,3549,9E
9,2006,2572,982,3554,9E
10,2006,2640,1032,3672,9E
11,2006,2640,1026,3666,9E
12,2006,2716,1144,3860,9E
1,2007,2476,1436,3912,9E
2,2007,2725,1198,3923,9E
3,2007,2795,1145,3940,9E
4,2007,2789,1174,3963,9E
5,2007,2770,1224,3994,9E
6,2007,2817,1280,4097,9E
7,2007,2865,1254,4119,9E
8,2007,2884,1223,4107,9E
9,2007,2929,1229,4158,9E
10,2007,2927,1189,4116,9E
11,2007,2919,1189,4108,9E
12,2007,2452,1662,4114,9E
1,2008,2979,1180,4159,9E
2,2008,3012,1166,4178,9E
3,2008,2890,1171,4061,9E
4,2008,2904,1159,4063,9E
5,2008,2934,1160,4094,9E
6,2008,2708,1432,4140,9E
7,2008,2970,1179,4149,9E
8,2008,2985,1189,4174,9E
9,2008,2996,1168,4164,9E
10,2008,3016,1156,4172,9E
11,2008,3023,1168,4191,9E
12,2008,3040,1164,4204,9E
1,2009,3040,1164,4204,9E
2,2009,3031,1158,4189,9E
3,2009,2874,1171,4045,9E
4,2009,2874,1171,4045,9E
5,2009,2809,1137,3946,9E
6,2009,2809,1137,3946,9E
7,2009,2745,1122,3867,9E
8,2009,2766,1164,3930,9E
9,2009,2803,1100,3903,9E
10,2009,2802,1100,3902,9E
11,2009,2788,1085,3873,9E
12,2009,2780,1071,3851,9E
1,2010,2774,1062,3836,9E
2,2010,2761,1032,3793,9E
3,2010,2778,1022,3800,9E
4,2010,2748,1060,3808,9E
5,2010,2761,1078,3839,9E
6,2010,2782,1077,3859,9E
7,2010,2758,1086,3844,9E
8,2010,2892,1084,3976,9E
9,2010,2888,1121,4009,9E
10,2010,2871,1099,3970,9E
11,2010,2900,1093,3993,9E
12,2010,2905,1071,3976,9E
1,2011,2898,1066,3964,9E
2,2011,2915,1066,3981,9E
3,2011,2953,1052,4005,9E
4,2011,3013,1020,4033,9E
5,2011,3057,1010,4067,9E
6,2011,3054,1002,4056,9E
7,2011,3131,991,4122,9E
8,2011,3166,982,4148,9E
9,2011,3174,976,4150,9E
10,2011,3272,972,4244,9E
11,2011,3266,958,4224,9E
12,2011,3389,944,4333,9E
1,2012,4774,821,5595,9E
2,2012,4683,809,5492,9E
3,2012,4663,795,5458,9E
4,2012,4305,751,5056,9E
5,2012,4453,749,5202,9E
6,2012,4422,767,5189,9E
7,2012,4461,684,5145,9E
8,2012,4247,514,4761,9E
9,2012,4209,162,4371,9E
10,2012,4647,205,4852,9E
11,2012,4650,199,4849,9E
12,2012,4634,196,4830,9E
1,2013,4798,208,5006,9E
2,2013,4398,174,4572,9E
3,2013,4346,171,4517,9E
4,2013,4320,147,4467,9E
5,2013,4295,145,4440,9E
6,2013,4082,125,4207,9E
7,2013,4033,122,4155,9E
8,2013,4009,119,4128,9E
9,2013,3977,118,4095,9E
10,2013,3993,117,4110,9E
11,2013,3932,110,4042,9E
12,2013,3880,79,3959,9E
1,2014,3868,86,3954,9E
2,2014,3836,112,3948,9E
3,2014,3797,120,3917,9E
4,2014,3765,113,3878,9E
5,2014,3782,112,3894,9E
6,2014,3760,111,3871,9E
7,2014,3731,108,3839,9E
8,2014,3686,109,3795,9E
9,2014,3612,108,3720,9E
10,2014,3555,107,3662,9E
11,2014,3497,106,3603,9E
12,2014,3395,103,3498,9E
1,2015,3339,87,3426,9E
2,2015,3256,99,3355,9E
3,2015,3253,97,3350,9E
4,2015,3222,96,3318,9E
5,2015,3200,94,3294,9E
6,2015,3186,91,3277,9E
7,2015,3202,90,3292,9E
8,2015,3197,91,3288,9E
9,2015,3207,87,3294,9E
10,2015,3230,90,3320,9E
11,2015,3245,96,3341,9E
12,2015,3244,95,3339,9E
1,2016,3273,96,3369,9E
2,2016,3284,95,3379,9E
3,2016,3341,96,3437,9E
4,2016,3384,96,3480,9E
5,2016,3428,94,3522,9E
6,2016,3497,101,3598,9E
7,2016,3581,99,3680,9E
8,2016,3595,103,3698,9E
9,2016,3642,106,3748,9E
10,2016,3662,104,3766,9E
11,2016,3714,102,3816,9E
12,2016,3718,100,3818,9E
1,2017,3761,100,3861,9E
2,2017,3790,103,3893,9E
3,2017,3787,104,3891,9E
4,2017,3830,104,3934,9E
5,2017,3872,107,3979,9E
6,2017,3843,105,3948,9E
7,2017,3893,105,3998,9E
8,2017,3905,105,4010,9E
9,2017,3940,104,4044,9E
10,2017,4011,106,4117,9E
11,2017,4101,108,4209,9E
12,2017,4123,108,4231,9E
1,2018,4191,109,4300,9E
2,2018,4250,112,4362,9E
3,2018,4314,119,4433,9E
4,2018,4347,117,4464,9E
5,2018,4368,120,4488,9E
6,2018,4392,117,4509,9E
7,2018,4443,112,4555,9E
8,2018,4485,105,4590,9E
9,2018,4503,107,4610,9E
10,2018,4531,106,4637,9E
11,2018,4535,107,4642,9E
12,2018,4485,110,4595,9E
1,2019,4459,111,4570,9E
2,2019,4460,111,4571,9E
3,2019,4411,108,4519,9E
4,2019,4439,108,4547,9E
5,2019,4483,112,4595,9E
6,2019,4456,112,4568,9E
7,2019,4474,111,4585,9E
8,2019,4538,104,4642,9E
9,2019,4626,101,4727,9E
10,2019,4635,99,4734,9E
11,2019,4740,101,4841,9E
12,2019,4743,104,4847,9E
1,2020,4741,103,4844,9E
2,2020,4822,102,4924,9E
3,2020,4515,83,4598,9E
4,2020,4439,92,4531,9E
5,2020,3262,22,3284,9E
6,2020,3670,29,3699,9E
7,2020,4118,54,4172,9E
8,2020,4143,56,4199,9E
9,2020,4287,65,4352,9E
10,2020,4298,69,4367,9E
11,2020,4323,69,4392,9E
12,2020,4294,69,4363,9E
1,2021,4220,70,4290,9E
2,2021,4334,77,4411,9E
3,2021,4378,75,4453,9E
4,2021,4516,73,4589,9E
5,2021,4619,74,4693,9E
6,2021,4717,72,4789,9E
7,2021,4779,74,4853,9E
8,2021,4878,95,4973,9E
9,2021,4936,93,5029,9E
10,2021,4979,88,5067,9E
11,2021,5034,90,5124,9E
12,2021,4953,93,5046,9E
1,2022,4956,92,5048,9E
2,2022,4979,93,5072,9E
3,2022,4919,95,5014,9E
4,2022,4902,95,4997,9E
5,2022,4852,108,4960,9E
6,2022,4902,95,4997,9E
7,2022,4774,100,4874,9E
8,2022,4792,97,4889,9E
9,2022,4797,95,4892,9E
10,2022,4865,95,4960,9E
11,2022,4915,93,5008,9E
12,2022,4822,96,4918,9E
1,2023,4686,77,4763,9E
2,2023,4725,72,4797,9E
3,2023,4696,69,4765,9E
4,2023,4649,68,4717,9E
5,2023,4571,76,4647,9E
6,2023,4504,74,4578,9E
7,2023,4426,90,4516,9E
8,2023,4335,77,4412,9E
9,2023,4345,88,4433,9E
10,2023,4354,83,4437,9E
11,2023,4390,79,4469,9E
12,2023,4315,77,4392,9E
1,2024,4300,74,4374,9E
2,2024,4332,74,4406,9E
3,2024,4388,78,4466,9E
4,2024,4415,77,4492,9E
5,2024,4430,85,4515,9E
6,2024,4431,86,4517,9E
7,2024,4488,85,4573,9E
8,2024,4509,81,4590,9E
9,2024,4485,78,4563,9E
10,2024,4462,76,4538,9E
11,2024,4484,74,4558,9E
12,2024,4459,73,4532,9E
1,2025,4467,70,4537,9E
1,1990,68137,9039,77176,AA
2,1990,68725,9273,77998,AA
3,1990,69509,9376,78885,AA
4,1990,69713,9326,79039,AA
5,1990,70376,9309,79685,AA
6,1990,71258,9369,80627,AA
7,1990,72018,9651,81669,AA
8,1990,72513,9694,82207,AA
9,1990,72776,9788,82564,AA
10,1990,73111,9737,82848,AA
11,1990,73171,9492,82663,AA
12,1990,73726,9507,83233,AA
1,1991,73867,9426,83293,AA
2,1991,73490,9934,83424,AA
3,1991,73538,10192,83730,AA
4,1991,74075,10246,84321,AA
5,1991,74853,10427,85280,AA
6,1991,75683,10716,86399,AA
7,1991,76563,10876,87439,AA
8,1991,76887,11029,87916,AA
9,1991,82579,12560,95139,AA
10,1991,82722,12785,95507,AA
11,1991,83237,12293,95530,AA
12,1991,83561,12531,96092,AA
1,1992,83649,12361,96010,AA
2,1992,83428,12741,96169,AA
3,1992,83444,12644,96088,AA
4,1992,83514,12880,96394,AA
5,1992,83615,12747,96362,AA
6,1992,84149,12953,97102,AA
7,1992,84434,13174,97608,AA
8,1992,85148,13404,98552,AA
9,1992,85387,13333,98720,AA
10,1992,85203,13416,98619,AA
11,1992,85063,13025,98088,AA
12,1992,84716,13283,97999,AA
1,1993,84622,13396,98018,AA
2,1993,84654,13857,98511,AA
3,1993,84827,13815,98642,AA
4,1993,84687,13860,98547,AA
5,1993,84274,14185,98459,AA
6,1993,83730,14395,98125,AA
7,1993,83483,14463,97946,AA
8,1993,83306,14498,97804,AA
9,1993,82940,14170,97110,AA
10,1993,82694,13951,96645,AA
11,1993,84590,12831,97421,AA
12,1993,83047,12901,95948,AA
1,1994,81485,14034,95519,AA
2,1994,80886,14117,95003,AA
3,1994,80572,14065,94637,AA
4,1994,80584,13950,94534,AA
5,1994,79337,14725,94062,AA
6,1994,79144,14846,93990,AA
7,1994,78765,14915,93680,AA
8,1994,78786,14976,93762,AA
9,1994,78923,14224,93147,AA
10,1994,78678,14170,92848,AA
11,1994,78060,14472,92532,AA
12,1994,77822,14617,92439,AA
1,1995,78112,13883,91995,AA
2,1995,78095,13431,91526,AA
3,1995,78112,13313,91425,AA
4,1995,77802,13177,90979,AA
5,1995,78053,12799,90852,AA
6,1995,78276,12704,90980,AA
7,1995,78292,12779,91071,AA
8,1995,78335,12783,91118,AA
9,1995,78764,12519,91283,AA
10,1995,78680,12564,91244,AA
11,1995,79104,12806,91910,AA
12,1995,79349,13260,92609,AA
1,1996,79586,13466,93052,AA
2,1996,79807,13210,93017,AA
3,1996,79425,13231,92656,AA
4,1996,79172,13144,92316,AA
5,1996,78456,13576,92032,AA
6,1996,78446,13722,92168,AA
7,1996,71789,13722,85511,AA
8,1996,73716,12268,85984,AA
9,1996,72053,13607,85660,AA
10,1996,72122,13580,85702,AA
11,1996,72287,13553,85840,AA
12,1996,74303,12296,86599,AA
1,1997,72590,13635,86225,AA
2,1997,72365,13735,86100,AA
3,1997,72069,14177,86246,AA
4,1997,72053,14219,86272,AA
5,1997,73134,13374,86508,AA
6,1997,73736,13512,87248,AA
7,1997,73988,13882,87870,AA
8,1997,74977,13358,88335,AA
9,1997,73993,13800,87793,AA
10,1997,73889,13783,87672,AA
11,1997,73893,13817,87710,AA
12,1997,74735,13568,88303,AA
1,1998,73967,13732,87699,AA
2,1998,73534,13868,87402,AA
3,1998,73680,13889,87569,AA
4,1998,73721,13846,87567,AA
5,1998,73386,14233,87619,AA
6,1998,73754,14322,88076,AA
7,1998,74047,14443,88490,AA
8,1998,75472,13850,89322,AA
9,1998,74643,14435,89078,AA
10,1998,75109,14446,89555,AA
11,1998,75426,14497,89923,AA
12,1998,76343,14117,90460,AA
1,1999,75251,14720,89971,AA
2,1999,76231,14707,90938,AA
3,1999,76682,14590,91272,AA
4,1999,77024,14881,91905,AA
5,1999,77645,15042,92687,AA
6,1999,78217,15118,93335,AA
7,1999,78872,15447,94319,AA
8,1999,80007,14901,94908,AA
9,1999,80737,15502,96239,AA
10,1999,80987,15360,96347,AA
11,1999,81162,15281,96443,AA
12,1999,82264,14935,97199,AA
1,2000,81420,15474,96894,AA
2,2000,81769,15585,97354,AA
3,2000,82755,15541,98296,AA
4,2000,82701,15439,98140,AA
5,2000,83064,15459,98523,AA
6,2000,83605,15562,99167,AA
7,2000,83767,15529,99296,AA
8,2000,85140,14676,99816,AA
9,2000,84636,15143,99779,AA
10,2000,85069,15035,100104,AA
11,2000,85675,14995,100670,AA
12,2000,86683,14536,101219,AA
1,2001,86075,15133,101208,AA
2,2001,86275,15083,101358,AA
3,2001,87025,15183,102208,AA
4,2001,87286,15140,102426,AA
5,2001,87156,15162,102318,AA
6,2001,87286,15140,102426,AA
7,2001,88665,15177,103842,AA
8,2001,88665,14177,102842,AA
9,2001,84660,13279,97939,AA
10,2001,84016,12838,96854,AA
11,2001,78113,13298,91411,AA
12,2001,77692,13384,91076,AA
1,2002,90518,14972,105490,AA
2,2002,89655,14577,104232,AA
3,2002,88806,14575,103381,AA
4,2002,88586,14421,103007,AA
5,2002,91364,15014,106378,AA
6,2002,91332,15247,106579,AA
7,2002,90721,15817,106538,AA
8,2002,91839,15472,107311,AA
9,2002,91774,15295,107069,AA
10,2002,91521,15447,106968,AA
11,2002,88988,14826,103814,AA
12,2002,88256,13857,102113,AA
1,2003,87837,13777,101614,AA
2,2003,88256,13857,102113,AA
3,2003,83708,13686,97394,AA
4,2003,82511,13571,96082,AA
5,2003,81207,13372,94579,AA
6,2003,78935,13146,92081,AA
7,2003,76097,12299,88396,AA
8,2003,75801,12236,88037,AA
9,2003,74646,12037,86683,AA
10,2003,73599,11569,85168,AA
11,2003,73858,11611,85469,AA
12,2003,73858,11611,85469,AA
1,2004,73581,11254,84835,AA
2,2004,73618,11136,84754,AA
3,2004,73455,11186,84641,AA
4,2004,73520,11187,84707,AA
5,2004,73596,11149,84745,AA
6,2004,73480,11169,84649,AA
7,2004,74259,11145,85404,AA
8,2004,74245,11137,85382,AA
9,2004,73636,11060,84696,AA
10,2004,73209,10905,84114,AA
11,2004,73287,10986,84273,AA
12,2004,72260,11028,83288,AA
1,2005,71232,10990,82222,AA
2,2005,70592,10910,81502,AA
3,2005,70184,11007,81191,AA
4,2005,69892,11063,80955,AA
5,2005,70495,11136,81631,AA
6,2005,70306,11282,81588,AA
7,2005,74087,12814,86901,AA
8,2005,70200,11409,81609,AA
9,2005,69864,11192,81056,AA
10,2005,69571,11063,80634,AA
11,2005,69466,11111,80577,AA
12,2005,69130,11388,80518,AA
1,2006,69028,11337,80365,AA
2,2006,68982,11268,80250,AA
3,2006,68825,11204,80029,AA
4,2006,68792,10998,79790,AA
5,2006,68205,11252,79457,AA
6,2006,68069,10712,78781,AA
7,2006,67954,10691,78645,AA
8,2006,68037,10585,78622,AA
9,2006,67640,10543,78183,AA
10,2006,67438,10566,78004,AA
11,2006,67861,10566,78427,AA
12,2006,67768,10402,78170,AA
1,2007,67521,10345,77866,AA
2,2007,67384,10264,77648,AA
3,2007,67809,10739,78548,AA
4,2007,67813,10721,78534,AA
5,2007,67870,10710,78580,AA
6,2007,67606,10672,78278,AA
7,2007,67583,10643,78226,AA
8,2007,67812,10616,78428,AA
9,2007,67939,10514,78453,AA
10,2007,68004,10510,78514,AA
11,2007,67849,10873,78722,AA
12,2007,67747,10954,78701,AA
1,2008,67834,10898,78732,AA
2,2008,67738,10827,78565,AA
3,2008,67694,10799,78493,AA
4,2008,67679,10764,78443,AA
5,2008,67902,10732,78634,AA
6,2008,67787,10669,78456,AA
7,2008,67771,10667,78438,AA
8,2008,67187,10628,77815,AA
9,2008,65522,10179,75701,AA
10,2008,65326,10132,75458,AA
11,2008,65143,9990,75133,AA
12,2008,65134,9940,75074,AA
1,2009,64987,9917,74904,AA
2,2009,64979,9912,74891,AA
3,2009,64977,9913,74890,AA
4,2009,64975,9911,74886,AA
5,2009,63500,9832,73332,AA
6,2009,63404,9742,73146,AA
7,2009,63258,9664,72922,AA
8,2009,62959,9692,72651,AA
9,2009,62917,9604,72521,AA
10,2009,62027,9750,71777,AA
11,2009,61680,9666,71346,AA
12,2009,61855,9595,71450,AA
1,2010,61983,9300,71283,AA
2,2010,61906,9263,71169,AA
3,2010,61485,9363,70848,AA
4,2010,61209,9351,70560,AA
5,2010,61094,9342,70436,AA
6,2010,61291,9204,70495,AA
7,2010,61184,9161,70345,AA
8,2010,61133,9164,70297,AA
9,2010,60829,9083,69912,AA
10,2010,60766,9033,69799,AA
11,2010,60843,9036,69879,AA
12,2010,61229,8987,70216,AA
1,2011,61197,8966,70163,AA
2,2011,61571,8925,70496,AA
3,2011,61709,8983,70692,AA
4,2011,61911,8992,70903,AA
5,2011,61832,9038,70870,AA
6,2011,61977,9004,70981,AA
7,2011,62053,9016,71069,AA
8,2011,61831,8942,70773,AA
9,2011,61838,8909,70747,AA
10,2011,62019,8914,70933,AA
11,2011,61921,8872,70793,AA
12,2011,61684,8893,70577,AA
1,2012,61435,8865,70300,AA
2,2012,61016,8794,69810,AA
3,2012,61544,7851,69395,AA
4,2012,61383,7813,69196,AA
5,2012,61111,7738,68849,AA
6,2012,60743,7676,68419,AA
7,2012,60029,8390,68419,AA
8,2012,59655,8193,67848,AA
9,2012,59352,8089,67441,AA
10,2012,58761,7878,66639,AA
11,2012,57783,7347,65130,AA
12,2012,56024,7099,63123,AA
1,2013,55890,7072,62962,AA
2,2013,55959,7004,62963,AA
3,2013,55519,6973,62492,AA
4,2013,55597,6899,62496,AA
5,2013,55420,6915,62335,AA
6,2013,55735,6856,62591,AA
7,2013,55637,6837,62474,AA
8,2013,55726,6827,62553,AA
9,2013,55462,6828,62290,AA
10,2013,55838,6821,62659,AA
11,2013,56038,6847,62885,AA
12,2013,56017,6882,62899,AA
1,2014,56245,6881,63126,AA
2,2014,56242,6914,63156,AA
3,2014,56372,6926,63298,AA
4,2014,56435,6927,63362,AA
5,2014,56288,6918,63206,AA
6,2014,56391,6900,63291,AA
7,2014,56480,6964,63444,AA
8,2014,56174,6856,63030,AA
9,2014,56419,6819,63238,AA
10,2014,57043,6835,63878,AA
11,2014,57208,6812,64020,AA
12,2014,57308,6811,64119,AA
1,2015,57549,6900,64449,AA
2,2015,57891,7038,64929,AA
3,2015,58443,7294,65737,AA
4,2015,59068,7370,66438,AA
5,2015,59529,7390,66919,AA
6,2015,59905,7427,67332,AA
7,2015,90786,12080,102866,AA
8,2015,90620,12198,102818,AA
9,2015,90592,12215,102807,AA
10,2015,90810,12126,102936,AA
11,2015,91294,12133,103427,AA
12,2015,91242,12085,103327,AA
1,2016,91482,12054,103536,AA
2,2016,91407,11995,103402,AA
3,2016,91694,12058,103752,AA
4,2016,91917,12085,104002,AA
5,2016,92372,12112,104484,AA
6,2016,92653,12022,104675,AA
7,2016,92797,12022,104819,AA
8,2016,92938,11962,104900,AA
9,2016,93022,12030,105052,AA
10,2016,93065,12251,105316,AA
11,2016,93349,12154,105503,AA
12,2016,93435,12145,105580,AA
1,2017,93400,12179,105579,AA
2,2017,93721,12248,105969,AA
3,2017,94139,12312,106451,AA
4,2017,93896,12433,106329,AA
5,2017,94281,12494,106775,AA
6,2017,94110,12922,107032,AA
7,2017,94325,12982,107307,AA
8,2017,94123,13148,107271,AA
9,2017,94096,13165,107261,AA
10,2017,94144,13136,107280,AA
11,2017,94110,13115,107225,AA
12,2017,94080,13130,107210,AA
1,2018,94256,13151,107407,AA
2,2018,94303,13197,107500,AA
3,2018,94756,13303,108059,AA
4,2018,95457,12770,108227,AA
5,2018,96153,12750,108903,AA
6,2018,96543,12628,109171,AA
7,2018,96407,12538,108945,AA
8,2018,96005,12511,108516,AA
9,2018,95964,12450,108414,AA
10,2018,95915,12412,108327,AA
11,2018,95215,12358,107573,AA
12,2018,95249,12341,107590,AA
1,2019,94446,12353,106799,AA
2,2019,94466,12235,106701,AA
3,2019,94993,12279,107272,AA
4,2019,95373,12158,107531,AA
5,2019,95595,12178,107773,AA
6,2019,96045,12062,108107,AA
7,2019,95806,12012,107818,AA
8,2019,95061,11915,106976,AA
9,2019,95069,11912,106981,AA
10,2019,95541,11889,107430,AA
11,2019,95225,11899,107124,AA
12,2019,95518,11863,107381,AA
1,2020,95612,11840,107452,AA
2,2020,96021,11884,107905,AA
3,2020,97373,11735,109108,AA
4,2020,97083,11496,108579,AA
5,2020,96062,11284,107346,AA
6,2020,96061,11191,107252,AA
7,2020,95792,11236,107028,AA
8,2020,95312,11232,106544,AA
9,2020,95197,10973,106170,AA
10,2020,79281,11565,90846,AA
11,2020,78761,11613,90374,AA
12,2020,88418,12587,101005,AA
1,2021,87926,12483,100409,AA
2,2021,90255,11187,101442,AA
3,2021,90243,11060,101303,AA
4,2021,88211,10682,98893,AA
5,2021,86714,10951,97665,AA
6,2021,87718,11022,98740,AA
7,2021,88130,11023,99153,AA
8,2021,88345,10943,99288,AA
9,2021,86522,10968,97490,AA
10,2021,85979,11130,97109,AA
11,2021,86112,11414,97526,AA
12,2021,86324,11557,97881,AA
1,2022,87377,11823,99200,AA
2,2022,87999,12066,100065,AA
3,2022,89059,12453,101512,AA
4,2022,89379,12766,102145,AA
5,2022,90332,12814,103146,AA
6,2022,90598,12958,103556,AA
7,2022,90647,12944,103591,AA
8,2022,90399,12985,103384,AA
9,2022,90867,12861,103728,AA
10,2022,91114,12694,103808,AA
11,2022,91439,12625,104064,AA
12,2022,91293,12550,103843,AA
1,2023,92038,12507,104545,AA
2,2023,92443,12424,104867,AA
3,2023,93199,12553,105752,AA
4,2023,94248,12606,106854,AA
5,2023,95103,12709,107812,AA
6,2023,95655,12658,108313,AA
7,2023,95458,12509,107967,AA
8,2023,95286,12526,107812,AA
9,2023,95362,12601,107963,AA
10,2023,95722,12648,108370,AA
11,2023,95892,12535,108427,AA
12,2023,95285,12416,107701,AA
1,2024,95588,12370,107958,AA
2,2024,95654,12332,107986,AA
3,2024,95827,12306,108133,AA
4,2024,95864,12387,108251,AA
5,2024,96324,12373,108697,AA
6,2024,96543,12347,108890,AA
7,2024,96220,12266,108486,AA
8,2024,95149,12131,107280,AA
9,2024,95044,12247,107291,AA
10,2024,95921,12376,108297,AA
11,2024,95686,12357,108043,AA
12,2024,95328,12241,107569,AA
1,2025,94936,12216,107152,AA
1,1990,4993,714,5707,AS
2,1990,5010,751,5761,AS
3,1990,5066,760,5826,AS
4,1990,5110,802,5912,AS
5,1990,5277,779,6056,AS
6,1990,5512,782,6294,AS
7,1990,5522,780,6302,AS
8,1990,5532,779,6311,AS
9,1990,5277,856,6133,AS
10,1990,5348,853,6201,AS
11,1990,5276,820,6096,AS
12,1990,5308,818,6126,AS
1,1991,5230,793,6023,AS
2,1991,5271,786,6057,AS
3,1991,5311,780,6091,AS
4,1991,5366,795,6161,AS
5,1991,5565,821,6386,AS
6,1991,5806,838,6644,AS
7,1991,5910,797,6707,AS
8,1991,5895,822,6717,AS
9,1991,5767,795,6562,AS
10,1991,5753,820,6573,AS
11,1991,5723,823,6546,AS
12,1991,5775,828,6603,AS
1,1992,5697,821,6518,AS
2,1992,5710,822,6532,AS
3,1992,5710,860,6570,AS
4,1992,5830,890,6720,AS
5,1992,6073,879,6952,AS
6,1992,6207,946,7153,AS
7,1992,6249,924,7173,AS
8,1992,6177,930,7107,AS
9,1992,6051,877,6928,AS
10,1992,5993,884,6877,AS
11,1992,5854,879,6733,AS
12,1992,5729,882,6611,AS
1,1993,5729,882,6611,AS
2,1993,5417,886,6303,AS
3,1993,5534,847,6381,AS
4,1993,5470,859,6329,AS
5,1993,5757,923,6680,AS
6,1993,5966,869,6835,AS
7,1993,6009,871,6880,AS
8,1993,5868,862,6730,AS
9,1993,5688,812,6500,AS
10,1993,5407,790,6197,AS
11,1993,5410,819,6229,AS
12,1993,5424,806,6230,AS
1,1994,5444,804,6248,AS
2,1994,5577,730,6307,AS
3,1994,5624,744,6368,AS
4,1994,5671,752,6423,AS
5,1994,5897,841,6738,AS
6,1994,6077,875,6952,AS
7,1994,6131,888,7019,AS
8,1994,6162,839,7001,AS
9,1994,6041,830,6871,AS
10,1994,6076,841,6917,AS
11,1994,6074,843,6917,AS
12,1994,6077,847,6924,AS
1,1995,6072,831,6903,AS
2,1995,6091,809,6900,AS
3,1995,6091,868,6959,AS
4,1995,6075,851,6926,AS
5,1995,6300,927,7227,AS
6,1995,6358,1023,7381,AS
7,1995,6406,1044,7450,AS
8,1995,6407,993,7400,AS
9,1995,6403,972,7375,AS
10,1995,6415,946,7361,AS
11,1995,6475,930,7405,AS
12,1995,6515,953,7468,AS
1,1996,6524,971,7495,AS
2,1996,6630,908,7538,AS
3,1996,6695,894,7589,AS
4,1996,6685,949,7634,AS
5,1996,6837,979,7816,AS
6,1996,7081,1053,8134,AS
7,1996,7141,1051,8192,AS
8,1996,7153,1035,8188,AS
9,1996,7050,1043,8093,AS
10,1996,7076,1045,8121,AS
11,1996,7145,1059,8204,AS
12,1996,7219,1098,8317,AS
1,1997,7206,1061,8267,AS
2,1997,7253,1082,8335,AS
3,1997,7284,1088,8372,AS
4,1997,7314,1151,8465,AS
5,1997,7435,1194,8629,AS
6,1997,7435,1194,8629,AS
7,1997,7675,1231,8906,AS
8,1997,7637,1207,8844,AS
9,1997,7599,1195,8794,AS
10,1997,7496,1163,8659,AS
11,1997,7477,1188,8665,AS
12,1997,7426,1157,8583,AS
1,1998,7439,1176,8615,AS
2,1998,7548,1189,8737,AS
3,1998,7637,1188,8825,AS
4,1998,7698,1214,8912,AS
5,1998,7884,1284,9168,AS
6,1998,7997,1326,9323,AS
7,1998,8024,1373,9397,AS
8,1998,8018,1370,9388,AS
9,1998,7899,1377,9276,AS
10,1998,7911,1358,9269,AS
11,1998,7927,1345,9272,AS
12,1998,7946,1357,9303,AS
1,1999,7916,1326,9242,AS
2,1999,8027,1315,9342,AS
3,1999,8142,1301,9443,AS
4,1999,8283,1306,9589,AS
5,1999,8346,1308,9654,AS
6,1999,8441,1325,9766,AS
7,1999,8515,1299,9814,AS
8,1999,8519,1297,9816,AS
9,1999,8413,1308,9721,AS
10,1999,8354,1286,9640,AS
11,1999,8400,1258,9658,AS
12,1999,8387,1270,9657,AS
1,2000,8360,1241,9601,AS
2,2000,8372,1239,9611,AS
3,2000,8395,1218,9613,AS
4,2000,8460,1197,9657,AS
5,2000,8582,1185,9767,AS
6,2000,8704,1204,9908,AS
7,2000,8726,1178,9904,AS
8,2000,8821,1170,9991,AS
9,2000,8726,1178,9904,AS
10,2000,8917,1204,10121,AS
11,2000,9066,1214,10280,AS
12,2000,9112,1221,10333,AS
1,2001,9172,1203,10375,AS
2,2001,9317,1253,10570,AS
3,2001,9450,1227,10677,AS
4,2001,9494,1245,10739,AS
5,2001,9623,1308,10931,AS
6,2001,9680,1286,10966,AS
7,2001,9670,1309,10979,AS
8,2001,9620,1313,10933,AS
9,2001,9487,1339,10826,AS
10,2001,9408,1319,10727,AS
11,2001,9195,1362,10557,AS
12,2001,9179,1336,10515,AS
1,2002,9141,1323,10464,AS
2,2002,9161,1326,10487,AS
3,2002,9204,1336,10540,AS
4,2002,9359,1331,10690,AS
5,2002,9564,1309,10873,AS
6,2002,9621,1338,10959,AS
7,2002,9635,1354,10989,AS
8,2002,9659,1332,10991,AS
9,2002,9612,1341,10953,AS
10,2002,9508,1307,10815,AS
11,2002,9545,1307,10852,AS
12,2002,9521,1302,10823,AS
1,2003,9539,1265,10804,AS
2,2003,9496,1290,10786,AS
3,2003,9479,1291,10770,AS
4,2003,9477,1281,10758,AS
5,2003,9530,1313,10843,AS
6,2003,9589,1252,10841,AS
7,2003,9562,1236,10798,AS
8,2003,9499,1220,10719,AS
9,2003,9405,1245,10650,AS
10,2003,9329,1228,10557,AS
11,2003,9339,1225,10564,AS
12,2003,9315,1218,10533,AS
1,2004,9286,1222,10508,AS
2,2004,9333,1231,10564,AS
3,2004,9241,1198,10439,AS
4,2004,9379,1237,10616,AS
5,2004,9529,1257,10786,AS
6,2004,9580,1235,10815,AS
7,2004,9643,1213,10856,AS
8,2004,9590,1184,10774,AS
9,2004,9216,1185,10401,AS
10,2004,9107,1141,10248,AS
11,2004,8827,1102,9929,AS
12,2004,8747,1110,9857,AS
1,2005,8626,1105,9731,AS
2,2005,8633,1112,9745,AS
3,2005,8653,1106,9759,AS
4,2005,8653,1148,9801,AS
5,2005,8387,1034,9421,AS
6,2005,8356,1027,9383,AS
7,2005,8491,995,9486,AS
8,2005,8490,996,9486,AS
9,2005,8514,1008,9522,AS
10,2005,8509,1014,9523,AS
11,2005,8497,1000,9497,AS
12,2005,8464,996,9460,AS
1,2006,8501,1027,9528,AS
2,2006,8490,1059,9549,AS
3,2006,8614,1058,9672,AS
4,2006,8695,1052,9747,AS
5,2006,8778,1056,9834,AS
6,2006,8931,1054,9985,AS
7,2006,8885,1114,9999,AS
8,2006,8953,1105,10058,AS
9,2006,8865,1114,9979,AS
10,2006,8841,1133,9974,AS
11,2006,8864,1096,9960,AS
12,2006,8882,1084,9966,AS
1,2007,8803,1079,9882,AS
2,2007,8818,1054,9872,AS
3,2007,8959,1042,10001,AS
4,2007,8937,1054,9991,AS
5,2007,9012,1050,10062,AS
6,2007,9082,1028,10110,AS
7,2007,9319,995,10314,AS
8,2007,9326,995,10321,AS
9,2007,9205,1071,10276,AS
10,2007,9288,1078,10366,AS
11,2007,9306,1098,10404,AS
12,2007,9302,1122,10424,AS
1,2008,9305,1120,10425,AS
2,2008,9368,1142,10510,AS
3,2008,9437,1158,10595,AS
4,2008,9481,1156,10637,AS
5,2008,9518,1152,10670,AS
6,2008,9557,1134,10691,AS
7,2008,9510,1125,10635,AS
8,2008,9440,1137,10577,AS
9,2008,9197,1227,10424,AS
10,2008,9213,1274,10487,AS
11,2008,8986,1283,10269,AS
12,2008,8937,1258,10195,AS
1,2009,8892,1220,10112,AS
2,2009,8893,1197,10090,AS
3,2009,8843,1202,10045,AS
4,2009,8877,1190,10067,AS
5,2009,8875,1185,10060,AS
6,2009,8946,1149,10095,AS
7,2009,8885,1168,10053,AS
8,2009,8798,1187,9985,AS
9,2009,8690,1275,9965,AS
10,2009,8637,1306,9943,AS
11,2009,8625,1293,9918,AS
12,2009,8620,1290,9910,AS
1,2010,8598,1288,9886,AS
2,2010,8591,1273,9864,AS
3,2010,8560,1276,9836,AS
4,2010,8535,1285,9820,AS
5,2010,8535,1283,9818,AS
6,2010,8583,1216,9799,AS
7,2010,8561,1198,9759,AS
8,2010,8511,1216,9727,AS
9,2010,8432,1248,9680,AS
10,2010,8321,1273,9594,AS
11,2010,8337,1278,9615,AS
12,2010,8321,1266,9587,AS
1,2011,8321,1265,9586,AS
2,2011,8269,1263,9532,AS
3,2011,8251,1275,9526,AS
4,2011,8277,1244,9521,AS
5,2011,8346,1238,9584,AS
6,2011,8450,1186,9636,AS
7,2011,8433,1173,9606,AS
8,2011,8342,1231,9573,AS
9,2011,8298,1258,9556,AS
10,2011,8283,1260,9543,AS
11,2011,8315,1258,9573,AS
12,2011,8340,1259,9599,AS
1,2012,8335,1259,9594,AS
2,2012,8379,1256,9635,AS
3,2012,8406,1249,9655,AS
4,2012,8406,1249,9655,AS
5,2012,8546,1246,9792,AS
6,2012,8607,1230,9837,AS
7,2012,8601,1224,9825,AS
8,2012,8629,1221,9850,AS
9,2012,8537,1337,9874,AS
10,2012,8533,1344,9877,AS
11,2012,8540,1336,9876,AS
12,2012,8607,1323,9930,AS
1,2013,8578,1344,9922,AS
2,2013,8648,1320,9968,AS
3,2013,8723,1311,10034,AS
4,2013,8760,1359,10119,AS
5,2013,8864,1356,10220,AS
6,2013,8885,1358,10243,AS
7,2013,8884,1365,10249,AS
8,2013,8860,1330,10190,AS
9,2013,8800,1359,10159,AS
10,2013,8815,1360,10175,AS
11,2013,8817,1363,10180,AS
12,2013,8828,1362,10190,AS
1,2014,8843,1349,10192,AS
2,2014,8893,1331,10224,AS
3,2014,8971,1315,10286,AS
4,2014,9123,1303,10426,AS
5,2014,9172,1305,10477,AS
6,2014,9255,1303,10558,AS
7,2014,9332,1313,10645,AS
8,2014,9319,1293,10612,AS
9,2014,9310,1291,10601,AS
10,2014,9432,1315,10747,AS
11,2014,9476,1311,10787,AS
12,2014,9548,1308,10856,AS
1,2015,9555,1294,10849,AS
2,2015,9693,1294,10987,AS
3,2015,9826,1305,11131,AS
4,2015,9929,1315,11244,AS
5,2015,10086,1318,11404,AS
6,2015,10225,1321,11546,AS
7,2015,10209,1324,11533,AS
8,2015,10265,1319,11584,AS
9,2015,10264,1351,11615,AS
10,2015,10266,1366,11632,AS
11,2015,10248,1375,11623,AS
12,2015,10237,1368,11605,AS
1,2016,10264,1383,11647,AS
2,2016,10279,1408,11687,AS
3,2016,10309,1395,11704,AS
4,2016,10358,1376,11734,AS
5,2016,10471,1376,11847,AS
6,2016,10570,1376,11946,AS
7,2016,10569,1368,11937,AS
8,2016,10612,1358,11970,AS
9,2016,10634,1386,12020,AS
10,2016,10747,1403,12150,AS
11,2016,10852,1389,12241,AS
12,2016,10837,1380,12217,AS
1,2017,10914,1400,12314,AS
2,2017,11090,1389,12479,AS
3,2017,11271,1400,12671,AS
4,2017,11474,1404,12878,AS
5,2017,11546,1399,12945,AS
6,2017,11770,1395,13165,AS
7,2017,11896,1409,13305,AS
8,2017,12067,1388,13455,AS
9,2017,12102,1444,13546,AS
10,2017,12259,1505,13764,AS
11,2017,12309,1510,13819,AS
12,2017,12391,1501,13892,AS
1,2018,15486,1937,17423,AS
2,2018,15596,1909,17505,AS
3,2018,15577,1910,17487,AS
4,2018,15693,1920,17613,AS
5,2018,15798,1868,17666,AS
6,2018,15811,1851,17662,AS
7,2018,15837,1826,17663,AS
8,2018,15768,1815,17583,AS
9,2018,15756,1896,17652,AS
10,2018,15774,1890,17664,AS
11,2018,15669,1887,17556,AS
12,2018,15669,1887,17556,AS
1,2019,15608,1894,17502,AS
2,2019,15659,1908,17567,AS
3,2019,15731,1859,17590,AS
4,2019,15773,1847,17620,AS
5,2019,15799,1886,17685,AS
6,2019,15765,1863,17628,AS
7,2019,15976,1839,17815,AS
8,2019,15992,1800,17792,AS
9,2019,16026,1842,17868,AS
10,2019,16022,1858,17880,AS
11,2019,16048,1799,17847,AS
12,2019,16060,1857,17917,AS
1,2020,16086,1853,17939,AS
2,2020,16070,1841,17911,AS
3,2020,16062,1850,17912,AS
4,2020,15840,2010,17850,AS
5,2020,15751,2046,17797,AS
6,2020,15691,2050,17741,AS
7,2020,15631,2009,17640,AS
8,2020,15585,1998,17583,AS
9,2020,15471,2010,17481,AS
10,2020,14683,1964,16647,AS
11,2020,14748,1948,16696,AS
12,2020,14706,1937,16643,AS
1,2021,14861,1875,16736,AS
2,2021,14882,1852,16734,AS
3,2021,14851,1822,16673,AS
4,2021,14810,1821,16631,AS
5,2021,14939,1786,16725,AS
6,2021,14992,1778,16770,AS
7,2021,14993,1758,16751,AS
8,2021,15905,1761,17666,AS
9,2021,15074,1761,16835,AS
10,2021,15230,1737,16967,AS
11,2021,15287,1733,17020,AS
12,2021,15342,1712,17054,AS
1,2022,15500,1701,17201,AS
2,2022,15735,1686,17421,AS
3,2022,16027,1694,17721,AS
4,2022,16436,1715,18151,AS
5,2022,16819,1751,18570,AS
6,2022,17175,1737,18912,AS
7,2022,17549,1722,19271,AS
8,2022,19117,220,19337,AS
9,2022,17672,1763,19435,AS
10,2022,17804,1792,19596,AS
11,2022,17836,1802,19638,AS
12,2022,17717,1832,19549,AS
1,2023,17645,1870,19515,AS
2,2023,17745,1889,19634,AS
3,2023,17829,1895,19724,AS
4,2023,18021,1915,19936,AS
5,2023,18074,1913,19987,AS
6,2023,18200,1948,20148,AS
7,2023,18298,1931,20229,AS
8,2023,18246,1927,20173,AS
9,2023,18170,2001,20171,AS
10,2023,18197,1998,20195,AS
11,2023,18179,2007,20186,AS
12,2023,18148,1996,20144,AS
1,2024,18113,2036,20149,AS
2,2024,18065,2065,20130,AS
3,2024,17982,2109,20091,AS
4,2024,18016,2114,20130,AS
5,2024,18068,2164,20232,AS
6,2024,18186,2166,20352,AS
7,2024,18137,2155,20292,AS
8,2024,18077,2143,20220,AS
9,2024,18060,2171,20231,AS
10,2024,18053,2190,20243,AS
11,2024,18109,2154,20263,AS
12,2024,18117,2143,20260,AS
1,2025,18145,2155,20300,AS
2,2000,275,175,450,B6
3,2000,310,195,505,B6
4,2000,360,210,570,B6
5,2000,424,161,585,B6
6,2000,452,176,628,B6
7,2000,532,186,718,B6
8,2000,590,227,817,B6
9,2000,689,258,947,B6
10,2000,764,277,1041,B6
11,2000,796,189,985,B6
12,2000,833,325,1158,B6
1,2001,967,373,1340,B6
2,2001,1123,393,1516,B6
3,2001,1137,384,1521,B6
4,2001,1214,392,1606,B6
5,2001,1221,452,1673,B6
6,2001,1272,498,1770,B6
7,2001,1345,524,1869,B6
8,2001,1407,560,1967,B6
9,2001,1509,556,2065,B6
10,2001,1551,598,2149,B6
11,2001,1644,626,2270,B6
12,2001,1700,661,2361,B6
1,2002,1927,645,2572,B6
2,2002,2030,613,2643,B6
3,2002,2145,604,2749,B6
4,2002,2271,637,2908,B6
5,2002,2349,645,2994,B6
6,2002,2455,638,3093,B6
7,2002,2607,703,3310,B6
8,2002,2697,751,3448,B6
9,2002,2884,730,3614,B6
10,2002,3152,638,3790,B6
11,2002,3275,683,3958,B6
12,2002,3359,652,4011,B6
1,2003,3538,755,4293,B6
2,2003,3639,444,4083,B6
3,2003,3679,731,4410,B6
4,2003,3870,742,4612,B6
5,2003,4123,743,4866,B6
6,2003,4057,780,4837,B6
7,2003,4108,801,4909,B6
8,2003,4232,784,5016,B6
9,2003,4393,813,5206,B6
10,2003,4491,863,5354,B6
11,2003,4779,828,5607,B6
12,2003,4704,849,5553,B6
1,2004,4810,875,5685,B6
2,2004,4861,918,5779,B6
3,2004,5021,945,5966,B6
4,2004,5074,970,6044,B6
5,2004,5208,1059,6267,B6
6,2004,5340,1116,6456,B6
7,2004,5477,1149,6626,B6
8,2004,5600,1205,6805,B6
9,2004,5603,1305,6908,B6
10,2004,5758,1336,7094,B6
11,2004,5900,1414,7314,B6
12,2004,5956,1443,7399,B6
1,2005,6131,1436,7567,B6
2,2005,6160,1422,7582,B6
3,2005,6287,1412,7699,B6
4,2005,6363,1435,7798,B6
5,2005,6507,1482,7989,B6
6,2005,6741,1527,8268,B6
7,2005,6885,1577,8462,B6
8,2005,6979,1520,8499,B6
9,2005,7109,1551,8660,B6
10,2005,7336,1593,8929,B6
11,2005,7490,1614,9104,B6
12,2005,7647,1601,9248,B6
1,2006,7930,1763,9693,B6
2,2006,8045,1827,9872,B6
3,2006,8233,2015,10248,B6
4,2006,8415,2065,10480,B6
5,2006,8551,2058,10609,B6
6,2006,8646,2058,10704,B6
7,2006,8663,2026,10689,B6
8,2006,8580,2041,10621,B6
9,2006,8568,2104,10672,B6
10,2006,8521,2168,10689,B6
11,2006,8465,2219,10684,B6
12,2006,8393,2231,10624,B6
1,2007,8378,2320,10698,B6
2,2007,8329,2276,10605,B6
3,2007,8418,2268,10686,B6
4,2007,8402,2364,10766,B6
5,2007,8360,2479,10839,B6
6,2007,8375,2599,10974,B6
7,2007,8351,2507,10858,B6
8,2007,8320,2577,10897,B6
9,2007,8331,2643,10974,B6
10,2007,8410,2788,11198,B6
11,2007,8707,2811,11518,B6
12,2007,8721,2847,11568,B6
1,2008,8918,2959,11877,B6
2,2008,8942,3007,11949,B6
3,2008,9000,3026,12026,B6
4,2008,9115,3039,12154,B6
5,2008,9111,2999,12110,B6
6,2008,9056,2934,11990,B6
7,2008,8969,2909,11878,B6
8,2008,8902,2877,11779,B6
9,2008,8834,2928,11762,B6
10,2008,8886,2947,11833,B6
11,2008,8901,2991,11892,B6
12,2008,8902,2950,11852,B6
1,2009,9019,2995,12014,B6
2,2009,9047,2983,12030,B6
3,2009,9027,2995,12022,B6
4,2009,9194,3138,12332,B6
5,2009,9200,3139,12339,B6
6,2009,9202,3147,12349,B6
7,2009,9157,3246,12403,B6
8,2009,9260,3323,12583,B6
9,2009,9115,3325,12440,B6
10,2009,9146,3310,12456,B6
11,2009,9182,3328,12510,B6
12,2009,9180,3352,12532,B6
1,2010,9371,3207,12578,B6
2,2010,9567,3268,12835,B6
3,2010,9667,3133,12800,B6
4,2010,9651,3097,12748,B6
5,2010,9698,3150,12848,B6
6,2010,9622,3223,12845,B6
7,2010,9620,3206,12826,B6
8,2010,9539,3223,12762,B6
9,2010,9482,3236,12718,B6
10,2010,9568,3353,12921,B6
11,2010,9606,3357,12963,B6
12,2010,9626,3322,12948,B6
1,2011,9720,3404,13124,B6
2,2011,9741,3433,13174,B6
3,2011,9851,3440,13291,B6
4,2011,9977,3535,13512,B6
5,2011,10104,3537,13641,B6
6,2011,10217,3597,13814,B6
7,2011,10150,3572,13722,B6
8,2011,10155,3526,13681,B6
9,2011,10146,3638,13784,B6
10,2011,10236,3743,13979,B6
11,2011,10240,3725,13965,B6
12,2011,10243,3779,14022,B6
1,2012,10467,3765,14232,B6
2,2012,10555,3807,14362,B6
3,2012,10606,3829,14435,B6
4,2012,10664,3860,14524,B6
5,2012,10800,3868,14668,B6
6,2012,10774,3834,14608,B6
7,2012,10788,3756,14544,B6
8,2012,10721,3683,14404,B6
9,2012,10592,3715,14307,B6
10,2012,10617,3777,14394,B6
11,2012,10574,3781,14355,B6
12,2012,10573,3774,14347,B6
1,2013,10703,3779,14482,B6
2,2013,10786,3784,14570,B6
3,2013,10852,3845,14697,B6
4,2013,10972,3799,14771,B6
5,2013,11099,3819,14918,B6
6,2013,11123,3812,14935,B6
7,2013,11115,3766,14881,B6
8,2013,11128,3739,14867,B6
9,2013,11042,3826,14868,B6
10,2013,11059,3867,14926,B6
11,2013,11019,3942,14961,B6
12,2013,11021,3862,14883,B6
1,2014,11184,3870,15054,B6
2,2014,11361,3879,15240,B6
3,2014,11546,3933,15479,B6
4,2014,11669,3937,15606,B6
5,2014,11747,4020,15767,B6
6,2014,11408,4030,15438,B6
7,2014,11502,4021,15523,B6
8,2014,11465,3981,15446,B6
9,2014,11392,3977,15369,B6
10,2014,11581,4033,15614,B6
11,2014,11646,4061,15707,B6
12,2014,11642,4046,15688,B6
1,2015,11690,4122,15812,B6
2,2015,11829,4144,15973,B6
3,2015,11852,4255,16107,B6
4,2015,12106,4481,16587,B6
5,2015,12308,4567,16875,B6
6,2015,12435,4566,17001,B6
7,2015,12510,4588,17098,B6
8,2015,12555,4633,17188,B6
9,2015,12587,4580,17167,B6
10,2015,12679,4669,17348,B6
11,2015,12833,4761,17594,B6
12,2015,12833,4771,17604,B6
1,2016,12861,4787,17648,B6
2,2016,12987,4791,17778,B6
3,2016,13104,4706,17810,B6
4,2016,13221,4815,18036,B6
5,2016,13328,4817,18145,B6
6,2016,13530,4838,18368,B6
7,2016,13705,4848,18553,B6
8,2016,13842,4849,18691,B6
9,2016,13903,4841,18744,B6
10,2016,14032,4925,18957,B6
11,2016,14191,4980,19171,B6
12,2016,14090,4881,18971,B6
1,2017,14314,4950,19264,B6
2,2017,14363,4977,19340,B6
3,2017,14498,5017,19515,B6
4,2017,14705,5037,19742,B6
5,2017,14900,5129,20029,B6
6,2017,15051,5097,20148,B6
7,2017,15089,5100,20189,B6
8,2017,15017,5196,20213,B6
9,2017,15019,5192,20211,B6
10,2017,15158,5214,20372,B6
11,2017,15182,5212,20394,B6
12,2017,15139,5178,20317,B6
1,2018,15198,5249,20447,B6
2,2018,15363,5231,20594,B6
3,2018,15435,5171,20606,B6
4,2018,15582,5201,20783,B6
5,2018,15711,5234,20945,B6
6,2018,15716,5255,20971,B6
7,2018,15743,5285,21028,B6
8,2018,15741,5242,20983,B6
9,2018,15817,5294,21111,B6
10,2018,15855,5326,21181,B6
11,2018,15789,5289,21078,B6
12,2018,15767,5212,20979,B6
1,2019,15995,5211,21206,B6
2,2019,16079,5254,21333,B6
3,2019,16280,5204,21484,B6
4,2019,16398,5206,21604,B6
5,2019,16498,5148,21646,B6
6,2019,16642,5099,21741,B6
7,2019,16591,5080,21671,B6
8,2019,16602,5032,21634,B6
9,2019,16674,4972,21646,B6
10,2019,16751,4930,21681,B6
11,2019,16780,4906,21686,B6
12,2019,16648,4851,21499,B6
1,2020,16738,4860,21598,B6
2,2020,16856,4865,21721,B6
3,2020,16745,4801,21546,B6
4,2020,16756,4778,21534,B6
5,2020,16470,5155,21625,B6
6,2020,16418,5138,21556,B6
7,2020,16389,5028,21417,B6
8,2020,16246,4661,20907,B6
9,2020,15735,3913,19648,B6
10,2020,15539,3709,19248,B6
11,2020,15464,3650,19114,B6
12,2020,15377,3605,18982,B6
1,2021,15377,3641,19018,B6
2,2021,15296,3670,18966,B6
3,2021,15267,3678,18945,B6
4,2021,15127,3724,18851,B6
5,2021,15135,3674,18809,B6
6,2021,15088,3905,18993,B6
7,2021,15135,4074,19209,B6
8,2021,15154,4174,19328,B6
9,2021,15490,4368,19858,B6
10,2021,15947,4427,20374,B6
11,2021,16109,4440,20549,B6
12,2021,16293,4387,20680,B6
1,2022,16674,4467,21141,B6
2,2022,17062,4401,21463,B6
3,2022,17604,4363,21967,B6
4,2022,17936,4331,22267,B6
5,2022,18288,4450,22738,B6
6,2022,18303,4539,22842,B6
7,2022,18409,4561,22970,B6
8,2022,18333,4545,22878,B6
9,2022,18558,4506,23064,B6
10,2022,18786,4486,23272,B6
11,2022,18797,4448,23245,B6
12,2022,18661,4319,22980,B6
1,2023,18674,4282,22956,B6
2,2023,18938,4248,23186,B6
3,2023,19177,4197,23374,B6
4,2023,19322,4211,23533,B6
5,2023,19454,4143,23597,B6
6,2023,19272,4331,23603,B6
7,2023,19334,4180,23514,B6
8,2023,19077,4365,23442,B6
9,2023,19123,4344,23467,B6
10,2023,19551,3882,23433,B6
11,2023,19487,3872,23359,B6
12,2023,19372,3819,23191,B6
1,2024,19509,3808,23317,B6
2,2024,19337,3531,22868,B6
3,2024,19334,3473,22807,B6
4,2024,19511,3457,22968,B6
5,2024,19506,3466,22972,B6
6,2024,19467,3479,22946,B6
7,2024,19384,3450,22834,B6
8,2024,19384,3312,22696,B6
9,2024,19288,3292,22580,B6
10,2024,19386,3169,22555,B6
11,2024,19386,3169,22555,B6
12,2024,19338,3102,22440,B6
1,2025,19384,3119,22503,B6
1,1990,56340,4226,60566,DL
2,1990,56413,4184,60597,DL
3,1990,56700,4117,60817,DL
4,1990,56630,4112,60742,DL
5,1990,56932,4156,61088,DL
6,1990,57478,4197,61675,DL
7,1990,58200,4377,62577,DL
8,1990,58220,4433,62653,DL
9,1990,57844,4433,62277,DL
10,1990,58190,4433,62623,DL
11,1990,57989,4450,62439,DL
12,1990,58413,4500,62913,DL
1,1991,58446,4531,62977,DL
2,1991,58938,4608,63546,DL
3,1991,59285,4794,64079,DL
4,1991,59716,4980,64696,DL
5,1991,60649,5076,65725,DL
6,1991,61392,5120,66512,DL
7,1991,62147,5167,67314,DL
8,1991,62179,5216,67395,DL
9,1991,63178,4860,68038,DL
10,1991,63927,4882,68809,DL
11,1991,71204,4929,76133,DL
12,1991,71512,5249,76761,DL
1,1992,71914,5325,77239,DL
2,1992,71915,5365,77280,DL
3,1992,72080,5325,77405,DL
4,1992,71949,5337,77286,DL
5,1992,72508,5338,77846,DL
6,1992,72507,5339,77846,DL
7,1992,72909,5233,78142,DL
8,1992,72433,5066,77499,DL
9,1992,71429,4430,75859,DL
10,1992,71013,4328,75341,DL
11,1992,70338,4373,74711,DL
12,1992,69370,4337,73707,DL
1,1993,68359,4387,72746,DL
2,1993,68047,4350,72397,DL
3,1993,67983,4405,72388,DL
4,1993,67916,4573,72489,DL
5,1993,68227,4866,73093,DL
6,1993,68379,5154,73533,DL
7,1993,68294,5309,73603,DL
8,1993,68155,5395,73550,DL
9,1993,67425,5638,73063,DL
10,1993,66822,5741,72563,DL
11,1993,65233,5755,70988,DL
12,1993,65212,5916,71128,DL
1,1994,64963,5854,70817,DL
2,1994,65698,4966,70664,DL
3,1994,65735,5425,71160,DL
4,1994,67750,5610,73360,DL
5,1994,65823,5745,71568,DL
6,1994,65595,5817,71412,DL
7,1994,65870,5746,71616,DL
8,1994,65428,5102,70530,DL
9,1994,61267,5405,66672,DL
10,1994,61424,6006,67430,DL
11,1994,60162,6680,66842,DL
12,1994,59327,6965,66292,DL
1,1995,56789,7082,63871,DL
2,1995,56632,7230,63862,DL
3,1995,56321,7258,63579,DL
4,1995,56141,7272,63413,DL
5,1995,55692,7367,63059,DL
6,1995,55063,7769,62832,DL
7,1995,52860,9590,62450,DL
8,1995,52810,9629,62439,DL
9,1995,52214,9564,61778,DL
10,1995,52056,9582,61638,DL
11,1995,52604,8906,61510,DL
12,1995,52654,8991,61645,DL
1,1996,51917,8984,60901,DL
2,1996,52033,8974,61007,DL
3,1996,51982,9128,61110,DL
4,1996,52243,9528,61771,DL
5,1996,53499,9963,63462,DL
6,1996,53969,10094,64063,DL
7,1996,54374,10059,64433,DL
8,1996,54484,10271,64755,DL
9,1996,54910,11388,66298,DL
10,1996,55238,11595,66833,DL
11,1996,55366,11262,66628,DL
12,1996,55735,11701,67436,DL
1,1997,55768,11416,67184,DL
2,1997,55995,11309,67304,DL
3,1997,56335,11516,67851,DL
4,1997,56590,11495,68085,DL
5,1997,56603,11742,68345,DL
6,1997,56865,12253,69118,DL
7,1997,57093,12828,69921,DL
8,1997,57301,12459,69760,DL
9,1997,57254,12248,69502,DL
10,1997,58011,11969,69980,DL
11,1997,57843,11790,69633,DL
12,1997,58104,11878,69982,DL
1,1998,58987,11483,70470,DL
2,1998,59978,11042,71020,DL
3,1998,60943,11019,71962,DL
4,1998,61612,10858,72470,DL
5,1998,62237,11292,73529,DL
6,1998,62648,11468,74116,DL
7,1998,62870,11477,74347,DL
8,1998,63007,12626,75633,DL
9,1998,62906,12816,75722,DL
10,1998,63089,12772,75861,DL
11,1998,62999,13328,76327,DL
12,1998,63569,13080,76649,DL
1,1999,63263,13619,76882,DL
2,1999,63425,13503,76928,DL
3,1999,63648,13681,77329,DL
4,1999,63857,13485,77342,DL
5,1999,63967,13340,77307,DL
6,1999,63931,13715,77646,DL
7,1999,64151,13711,77862,DL
8,1999,64000,13618,77618,DL
9,1999,63674,13912,77586,DL
10,1999,63931,13651,77582,DL
11,1999,63568,14160,77728,DL
12,1999,64175,13788,77963,DL
1,2000,63532,14449,77981,DL
2,2000,64263,13886,78149,DL
3,2000,65862,13102,78964,DL
4,2000,65862,13102,78964,DL
5,2000,66033,13246,79279,DL
6,2000,66364,13193,79557,DL
7,2000,66349,15138,81487,DL
8,2000,66297,13482,79779,DL
9,2000,65946,13853,79799,DL
10,2000,66490,13633,80123,DL
11,2000,66605,13359,79964,DL
12,2000,66758,13632,80390,DL
1,2001,66603,14061,80664,DL
2,2001,66147,14430,80577,DL
3,2001,66891,13488,80379,DL
4,2001,68739,13695,82434,DL
5,2001,69051,13908,82959,DL
6,2001,76877,6153,83030,DL
7,2001,69288,14184,83472,DL
8,2001,69095,13800,82895,DL
9,2001,68253,13952,82205,DL
10,2001,67423,13084,80507,DL
11,2001,64161,11957,76118,DL
12,2001,62401,11702,74103,DL
1,2002,60170,11194,71364,DL
2,2002,60264,11228,71492,DL
3,2002,60409,11195,71604,DL
4,2002,60340,9210,69550,DL
5,2002,60967,9217,70184,DL
6,2002,61143,9166,70309,DL
7,2002,61670,9184,70854,DL
8,2002,61560,9175,70735,DL
9,2002,61126,8969,70095,DL
10,2002,60942,9015,69957,DL
11,2002,60653,8846,69499,DL
12,2002,60002,8701,68703,DL
1,2003,58830,8371,67201,DL
2,2003,57875,8106,65981,DL
3,2003,57164,7855,65019,DL
4,2003,55545,6992,62537,DL
5,2003,55029,6862,61891,DL
6,2003,54897,6938,61835,DL
7,2003,55453,7147,62600,DL
8,2003,55469,7135,62604,DL
9,2003,55055,6822,61877,DL
10,2003,55220,6767,61987,DL
11,2003,55257,6611,61868,DL
12,2003,55281,6846,62127,DL
1,2004,55177,6431,61608,DL
2,2004,54920,6391,61311,DL
3,2004,54742,6195,60937,DL
4,2004,54901,6396,61297,DL
5,2004,55016,6435,61451,DL
6,2004,54616,6598,61214,DL
7,2004,54534,6631,61165,DL
8,2004,54534,6631,61165,DL
9,2004,53985,6516,60501,DL
10,2004,53890,6428,60318,DL
11,2004,53650,6400,60050,DL
12,2004,53394,6578,59972,DL
1,2005,52312,6478,58790,DL
2,2005,51269,6522,57791,DL
3,2005,50783,6614,57397,DL
4,2005,49690,6494,56184,DL
5,2005,50016,6412,56428,DL
6,2005,49488,6370,55858,DL
7,2005,49178,6322,55500,DL
8,2005,48826,6282,55108,DL
9,2005,47765,5960,53725,DL
10,2005,47412,5853,53265,DL
11,2005,46980,5569,52549,DL
12,2005,45933,5324,51257,DL
1,2006,45822,4162,49984,DL
2,2006,45307,4136,49443,DL
3,2006,45020,4108,49128,DL
4,2006,43895,4200,48095,DL
5,2006,43058,4297,47355,DL
6,2006,42929,4324,47253,DL
7,2006,43085,4362,47447,DL
8,2006,42851,4387,47238,DL
9,2006,42191,4438,46629,DL
10,2006,42241,4485,46726,DL
11,2006,41948,4462,46410,DL
12,2006,42443,4406,46849,DL
1,2007,42313,4419,46732,DL
2,2007,42816,4388,47204,DL
3,2007,43350,4509,47859,DL
4,2007,43636,4784,48420,DL
5,2007,44165,4819,48984,DL
6,2007,46446,4771,51217,DL
7,2007,46455,4823,51278,DL
8,2007,46073,4963,51036,DL
9,2007,45783,5021,50804,DL
10,2007,45917,4997,50914,DL
11,2007,46119,5105,51224,DL
12,2007,45860,5114,50974,DL
1,2008,45413,5240,50653,DL
2,2008,45898,5225,51123,DL
3,2008,46192,5320,51512,DL
4,2008,46315,5258,51573,DL
5,2008,46178,5305,51483,DL
6,2008,46371,5308,51679,DL
7,2008,45449,5226,50675,DL
8,2008,44579,5240,49819,DL
9,2008,43536,5466,49002,DL
10,2008,42942,5460,48402,DL
11,2008,42389,5558,47947,DL
12,2008,42607,5641,48248,DL
1,2009,42159,5650,47809,DL
2,2009,42449,5750,48199,DL
3,2009,42443,5990,48433,DL
4,2009,42386,5867,48253,DL
5,2009,42458,6049,48507,DL
6,2009,42492,6193,48685,DL
7,2009,42686,6520,49206,DL
8,2009,42694,6353,49047,DL
9,2009,42233,6199,48432,DL
10,2009,44704,8619,53323,DL
11,2009,44663,8659,53322,DL
12,2009,44633,8652,53285,DL
1,2010,69593,11139,80732,DL
2,2010,69186,10922,80108,DL
3,2010,69245,10965,80210,DL
4,2010,69263,10947,80210,DL
5,2010,69267,10805,80072,DL
6,2010,70125,10850,80975,DL
7,2010,69950,11025,80975,DL
8,2010,70180,11027,81207,DL
9,2010,70200,11187,81387,DL
10,2010,68372,9349,77721,DL
11,2010,68493,9358,77851,DL
12,2010,68500,9570,78070,DL
1,2011,69208,9571,78779,DL
2,2011,69681,9774,79455,DL
3,2011,70628,9555,80183,DL
4,2011,70462,9234,79696,DL
5,2011,70429,9806,80235,DL
6,2011,71379,10117,81496,DL
7,2011,71295,9984,81279,DL
8,2011,70952,9582,80534,DL
9,2011,69337,9417,78754,DL
10,2011,68690,9347,78037,DL
11,2011,68550,9638,78188,DL
12,2011,68415,9511,77926,DL
1,2012,68482,9384,77866,DL
2,2012,68725,9480,78205,DL
3,2012,68857,9736,78593,DL
4,2012,68861,10013,78874,DL
5,2012,69024,10674,79698,DL
6,2012,69313,10930,80243,DL
7,2012,69111,10885,79996,DL
8,2012,69098,10471,79569,DL
9,2012,67964,9507,77471,DL
10,2012,67865,9643,77508,DL
11,2012,67851,9721,77572,DL
12,2012,67669,9720,77389,DL
1,2013,68482,9384,77866,DL
2,2013,68725,9480,78205,DL
3,2013,68697,9396,78093,DL
4,2013,69021,9684,78705,DL
5,2013,69020,10529,79549,DL
6,2013,69348,10396,79744,DL
7,2013,69063,10297,79360,DL
8,2013,68911,9924,78835,DL
9,2013,68835,9219,78054,DL
10,2013,68768,9448,78216,DL
11,2013,68830,9490,78320,DL
12,2013,68587,9538,78125,DL
1,2014,68600,9544,78144,DL
2,2014,68817,9569,78386,DL
3,2014,69725,9592,79317,DL
4,2014,70027,9938,79965,DL
5,2014,70201,11037,81238,DL
6,2014,70567,10710,81277,DL
7,2014,70728,10746,81474,DL
8,2014,70611,10245,80856,DL
9,2014,70908,9416,80324,DL
10,2014,70893,9765,80658,DL
11,2014,70603,9767,80370,DL
12,2014,70755,9963,80718,DL
1,2015,71106,9809,80915,DL
2,2015,71315,10249,81564,DL
3,2015,71815,10379,82194,DL
4,2015,72437,10730,83167,DL
5,2015,73099,11242,84341,DL
6,2015,73532,11196,84728,DL
7,2015,73535,11163,84698,DL
8,2015,73812,10629,84441,DL
9,2015,74159,10232,84391,DL
10,2015,74122,10567,84689,DL
11,2015,73848,10536,84384,DL
12,2015,73693,10758,84451,DL
1,2016,73457,10511,83968,DL
2,2016,73803,10821,84624,DL
3,2016,74094,10948,85042,DL
4,2016,74507,10604,85111,DL
5,2016,74567,11232,85799,DL
6,2016,74601,11567,86168,DL
7,2016,74590,11398,85988,DL
8,2016,74632,11126,85758,DL
9,2016,74867,10257,85124,DL
10,2016,75079,10330,85409,DL
11,2016,73989,10715,84704,DL
12,2016,74198,10498,84696,DL
1,2017,74052,10210,84262,DL
2,2017,74327,10365,84692,DL
3,2017,75419,10588,86007,DL
4,2017,75658,10848,86506,DL
5,2017,75946,10951,86897,DL
6,2017,76799,11259,88058,DL
7,2017,76334,11229,87563,DL
8,2017,76475,10848,87323,DL
9,2017,76599,10195,86794,DL
10,2017,76960,10421,87381,DL
11,2017,76175,10662,86837,DL
12,2017,76285,10959,87244,DL
1,2018,76010,10953,86963,DL
2,2018,76150,11244,87394,DL
3,2018,77365,10799,88164,DL
4,2018,77600,10519,88119,DL
5,2018,78261,10430,88691,DL
6,2018,78339,10907,89246,DL
7,2018,80775,12673,93448,DL
8,2018,77903,10740,88643,DL
9,2018,78037,10240,88277,DL
10,2018,77951,10283,88234,DL
11,2018,77101,10640,87741,DL
12,2018,77285,10811,88096,DL
1,2019,78055,10684,88739,DL
2,2019,78645,10846,89491,DL
3,2019,79067,10892,89959,DL
4,2019,79307,10660,89967,DL
5,2019,79502,10929,90431,DL
6,2019,79601,11688,91289,DL
7,2019,79462,11651,91113,DL
8,2019,79502,11192,90694,DL
9,2019,79512,10417,89929,DL
10,2019,79931,10371,90302,DL
11,2019,79636,10360,89996,DL
12,2019,79841,10565,90406,DL
1,2020,80582,10245,90827,DL
2,2020,81177,10239,91416,DL
3,2020,80179,9801,89980,DL
4,2020,57498,4512,62010,DL
5,2020,47581,3403,50984,DL
6,2020,47877,3591,51468,DL
7,2020,56513,5563,62076,DL
8,2020,57630,5716,63346,DL
9,2020,55767,5743,61510,DL
10,2020,55384,5845,61229,DL
11,2020,56393,5885,62278,DL
12,2020,56827,5959,62786,DL
1,2021,56429,5758,62187,DL
2,2021,56933,5655,62588,DL
3,2021,58406,5821,64227,DL
4,2021,59348,6311,65659,DL
5,2021,61045,7288,68333,DL
6,2021,62248,9029,71277,DL
7,2021,68699,4805,73504,DL
8,2021,71804,3280,75084,DL
9,2021,74393,2787,77180,DL
10,2021,77410,2156,79566,DL
11,2021,78447,2380,80827,DL
12,2021,79299,2380,81679,DL
1,2022,80655,1965,82620,DL
2,2022,82439,1885,84324,DL
3,2022,83951,1823,85774,DL
4,2022,85359,1795,87154,DL
5,2022,86831,2364,89195,DL
6,2022,88649,3531,92180,DL
7,2022,89331,3568,92899,DL
8,2022,90039,2578,92617,DL
9,2022,91834,2094,93928,DL
10,2022,92459,1957,94416,DL
11,2022,93007,2449,95456,DL
12,2022,92734,2661,95395,DL
1,2023,94236,2508,96744,DL
2,2023,95551,2400,97951,DL
3,2023,96510,2219,98729,DL
4,2023,97513,1475,98988,DL
5,2023,98455,1884,100339,DL
6,2023,99404,2929,102333,DL
7,2023,99944,2990,102934,DL
8,2023,100435,2106,102541,DL
9,2023,101162,1699,102861,DL
10,2023,101724,1927,103651,DL
11,2023,101182,2922,104104,DL
12,2023,101436,2969,104405,DL
1,2024,100932,2268,103200,DL
2,2024,101834,2165,103999,DL
3,2024,102655,2189,104844,DL
4,2024,102384,1513,103897,DL
5,2024,103035,2046,105081,DL
6,2024,103018,3280,106298,DL
7,2024,102936,3296,106232,DL
8,2024,102943,2247,105190,DL
9,2024,103249,1443,104692,DL
10,2024,103279,1562,104841,DL
11,2024,102032,2106,104138,DL
12,2024,102223,2693,104916,DL
1,2025,102202,2185,104387,DL
7,1993,1713,198,1911,EV
8,1993,1763,207,1970,EV
9,1993,1792,220,2012,EV
10,1993,1829,229,2058,EV
11,1993,1845,245,2090,EV
12,1993,1857,252,2109,EV
1,1994,1864,247,2111,EV
2,1994,1856,250,2106,EV
3,1994,1873,252,2125,EV
4,1994,1868,246,2114,EV
5,1994,1869,252,2121,EV
6,1994,1890,257,2147,EV
7,1994,1916,258,2174,EV
8,1994,1913,257,2170,EV
9,1994,1930,256,2186,EV
10,1994,1917,260,2177,EV
11,1994,1926,260,2186,EV
12,1994,1931,260,2191,EV
1,1995,1902,260,2162,EV
2,1995,1902,260,2162,EV
3,1995,1913,265,2178,EV
4,1995,1926,261,2187,EV
5,1995,1948,270,2218,EV
6,1995,1952,280,2232,EV
7,1995,1962,284,2246,EV
8,1995,1945,289,2234,EV
9,1995,1962,277,2239,EV
10,1995,1957,265,2222,EV
11,1995,2000,266,2266,EV
12,1995,2062,274,2336,EV
1,1996,2052,273,2325,EV
2,1996,2058,288,2346,EV
3,1996,2094,288,2382,EV
4,1996,2088,293,2381,EV
5,1996,2114,290,2404,EV
6,1996,2120,285,2405,EV
7,1996,2158,288,2446,EV
8,1996,2146,297,2443,EV
9,1996,2165,297,2462,EV
10,1996,2201,293,2494,EV
11,1996,2198,282,2480,EV
12,1996,2196,264,2460,EV
1,1997,2172,265,2437,EV
2,1997,2170,263,2433,EV
3,1997,2179,277,2456,EV
4,1997,2213,271,2484,EV
5,1997,2227,283,2510,EV
6,1997,2222,266,2488,EV
7,1997,2195,260,2455,EV
8,1997,2235,261,2496,EV
9,1997,2240,257,2497,EV
10,1997,2224,251,2475,EV
11,1997,2224,251,2475,EV
12,1997,2270,264,2534,EV
1,1998,2233,261,2494,EV
2,1998,2227,277,2504,EV
3,1998,2208,260,2468,EV
4,1998,2214,251,2465,EV
5,1998,2222,246,2468,EV
6,1998,2238,269,2507,EV
7,1998,2277,272,2549,EV
8,1998,2286,257,2543,EV
9,1998,2308,270,2578,EV
10,1998,2236,366,2602,EV
11,1998,2349,257,2606,EV
12,1998,2337,260,2597,EV
1,1999,2336,261,2597,EV
2,1999,2363,267,2630,EV
3,1999,2372,257,2629,EV
4,1999,2393,264,2657,EV
5,1999,2393,264,2657,EV
6,1999,2439,265,2704,EV
7,1999,2422,261,2683,EV
8,1999,2539,266,2805,EV
9,1999,2591,263,2854,EV
10,1999,2682,248,2930,EV
11,1999,2754,268,3022,EV
12,1999,2822,260,3082,EV
1,2000,2869,265,3134,EV
2,2000,2986,280,3266,EV
3,2000,3020,299,3319,EV
4,2000,3211,146,3357,EV
5,2000,3207,267,3474,EV
6,2000,3372,262,3634,EV
7,2000,3372,588,3960,EV
8,2000,3403,281,3684,EV
9,2000,3496,536,4032,EV
10,2000,3530,266,3796,EV
11,2000,3647,263,3910,EV
12,2000,3735,268,4003,EV
1,2001,3823,272,4095,EV
2,2001,3923,288,4211,EV
3,2001,3912,311,4223,EV
4,2001,3952,366,4318,EV
5,2001,3840,331,4171,EV
6,2001,3853,332,4185,EV
7,2001,3896,321,4217,EV
8,2001,3955,320,4275,EV
9,2001,3972,316,4288,EV
10,2001,3964,310,4274,EV
11,2001,3990,301,4291,EV
12,2001,4067,265,4332,EV
1,2002,4105,268,4373,EV
2,2002,4196,265,4461,EV
3,2002,4247,302,4549,EV
4,2002,4278,310,4588,EV
5,2002,4393,324,4717,EV
6,2002,4430,327,4757,EV
7,2002,4492,331,4823,EV
8,2002,4645,314,4959,EV
9,2002,4724,353,5077,EV
10,2002,4794,353,5147,EV
11,2002,4864,352,5216,EV
12,2002,4907,349,5256,EV
1,2003,4957,410,5367,EV
2,2003,5011,374,5385,EV
3,2003,5081,372,5453,EV
4,2003,5091,378,5469,EV
5,2003,5100,388,5488,EV
6,2003,5125,403,5528,EV
7,2003,5164,409,5573,EV
8,2003,5156,408,5564,EV
9,2003,5157,415,5572,EV
10,2003,5238,417,5655,EV
11,2003,5229,481,5710,EV
12,2003,5236,466,5702,EV
1,2004,5214,472,5686,EV
2,2004,5191,515,5706,EV
3,2004,5298,549,5847,EV
4,2004,5355,554,5909,EV
5,2004,5385,612,5997,EV
6,2004,5416,602,6018,EV
7,2004,5470,616,6086,EV
8,2004,5448,576,6024,EV
9,2004,5631,452,6083,EV
10,2004,5601,415,6016,EV
11,2004,5568,398,5966,EV
12,2004,5523,389,5912,EV
1,2005,5548,384,5932,EV
2,2005,5251,327,5578,EV
3,2005,5283,326,5609,EV
4,2005,5289,316,5605,EV
5,2005,5323,327,5650,EV
6,2005,5366,314,5680,EV
7,2005,5383,307,5690,EV
8,2005,5376,328,5704,EV
9,2005,5353,313,5666,EV
10,2005,5408,307,5715,EV
11,2005,5419,308,5727,EV
12,2005,5402,300,5702,EV
1,2006,5300,300,5600,EV
2,2006,5147,294,5441,EV
3,2006,5132,294,5426,EV
4,2006,5283,302,5585,EV
5,2006,5235,326,5561,EV
6,2006,5312,326,5638,EV
7,2006,5407,324,5731,EV
8,2006,5428,329,5757,EV
9,2006,5436,323,5759,EV
10,2006,5510,338,5848,EV
11,2006,5558,338,5896,EV
12,2006,5497,320,5817,EV
1,2007,5583,328,5911,EV
2,2007,5844,341,6185,EV
3,2007,5494,338,5832,EV
4,2007,5414,321,5735,EV
5,2007,5433,318,5751,EV
6,2007,4222,250,4472,EV
7,2007,4247,218,4465,EV
8,2007,4209,225,4434,EV
9,2007,4234,218,4452,EV
10,2007,4270,210,4480,EV
11,2007,4179,201,4380,EV
12,2007,4204,181,4385,EV
1,2008,4291,193,4484,EV
2,2008,4356,203,4559,EV
3,2008,4381,206,4587,EV
4,2008,4408,203,4611,EV
5,2008,4444,201,4645,EV
6,2008,4414,206,4620,EV
7,2008,4381,194,4575,EV
8,2008,4334,220,4554,EV
9,2008,4320,225,4545,EV
10,2008,4305,214,4519,EV
11,2008,4261,37,4298,EV
12,2008,4252,202,4454,EV
1,2009,4223,187,4410,EV
2,2009,4118,182,4300,EV
3,2009,4076,172,4248,EV
4,2009,3949,153,4102,EV
5,2009,3854,145,3999,EV
6,2009,3764,137,3901,EV
7,2009,3616,162,3778,EV
8,2009,3548,156,3704,EV
9,2009,3540,164,3704,EV
10,2009,3539,156,3695,EV
11,2009,3511,154,3665,EV
12,2009,3516,170,3686,EV
1,2010,3419,172,3591,EV
2,2010,3468,178,3646,EV
3,2010,3461,170,3631,EV
4,2010,3508,181,3689,EV
5,2010,3526,183,3709,EV
6,2010,3525,172,3697,EV
7,2010,3544,169,3713,EV
8,2010,3541,173,3714,EV
9,2010,3514,174,3688,EV
10,2010,3626,166,3792,EV
11,2010,3658,158,3816,EV
12,2010,3630,160,3790,EV
1,2011,3597,213,3810,EV
2,2011,3648,167,3815,EV
3,2011,3617,161,3778,EV
4,2011,3676,159,3835,EV
5,2011,3670,168,3838,EV
6,2011,3687,179,3866,EV
7,2011,3719,180,3899,EV
8,2011,3753,176,3929,EV
9,2011,3781,171,3952,EV
10,2011,3777,183,3960,EV
11,2011,3747,210,3957,EV
12,2011,3735,210,3945,EV
1,2012,9135,503,9638,EV
2,2012,9184,515,9699,EV
3,2012,9173,514,9687,EV
4,2012,9197,501,9698,EV
5,2012,9178,509,9687,EV
6,2012,9177,498,9675,EV
7,2012,9140,480,9620,EV
8,2012,9035,405,9440,EV
9,2012,8923,335,9258,EV
10,2012,8845,179,9024,EV
11,2012,8774,99,8873,EV
12,2012,8733,91,8824,EV
1,2013,8793,77,8870,EV
2,2013,8763,76,8839,EV
3,2013,8813,69,8882,EV
4,2013,8839,68,8907,EV
5,2013,8839,68,8907,EV
6,2013,8964,68,9032,EV
7,2013,8986,67,9053,EV
8,2013,8987,69,9056,EV
9,2013,9003,68,9071,EV
10,2013,9052,67,9119,EV
11,2013,9051,67,9118,EV
12,2013,9021,66,9087,EV
1,2014,9145,66,9211,EV
2,2014,9168,65,9233,EV
3,2014,9191,63,9254,EV
4,2014,9303,60,9363,EV
5,2014,9279,85,9364,EV
6,2014,9298,65,9363,EV
7,2014,9234,65,9299,EV
8,2014,9190,62,9252,EV
9,2014,9059,65,9124,EV
10,2014,8903,83,8986,EV
11,2014,8758,83,8841,EV
12,2014,8630,81,8711,EV
1,2015,8484,82,8566,EV
2,2015,8803,85,8888,EV
3,2015,8325,78,8403,EV
4,2015,8134,77,8211,EV
5,2015,8029,76,8105,EV
6,2015,7876,98,7974,EV
7,2015,7774,106,7880,EV
8,2015,7657,102,7759,EV
9,2015,7603,103,7706,EV
10,2015,7564,102,7666,EV
11,2015,7433,99,7532,EV
12,2015,7345,98,7443,EV
1,2016,7276,97,7373,EV
2,2016,7182,94,7276,EV
3,2016,7055,90,7145,EV
4,2016,6916,85,7001,EV
5,2016,6821,86,6907,EV
6,2016,6742,73,6815,EV
7,2016,6668,70,6738,EV
8,2016,6571,68,6639,EV
9,2016,6534,66,6600,EV
10,2016,6449,66,6515,EV
11,2016,6367,63,6430,EV
12,2016,6247,62,6309,EV
1,2017,6202,61,6263,EV
2,2017,6136,62,6198,EV
3,2017,5953,60,6013,EV
4,2017,5784,59,5843,EV
5,2017,5684,55,5739,EV
6,2017,5537,46,5583,EV
7,2017,5418,43,5461,EV
8,2017,5227,42,5269,EV
9,2017,4984,42,5026,EV
10,2017,4698,36,4734,EV
11,2017,4511,34,4545,EV
12,2017,4378,29,4407,EV
1,2018,4221,26,4247,EV
2,2018,4101,26,4127,EV
3,2018,3987,25,4012,EV
4,2018,3864,25,3889,EV
5,2018,3743,24,3767,EV
6,2018,3609,24,3633,EV
7,2018,3564,23,3587,EV
8,2018,3463,16,3479,EV
9,2018,3292,20,3312,EV
10,2018,3105,20,3125,EV
11,2018,2950,20,2970,EV
12,2018,2918,20,2938,EV
1,2019,2918,20,2938,EV
2,2019,2774,2,2776,EV
3,2019,2744,2,2746,EV
4,2019,2668,4,2672,EV
5,2019,2662,7,2669,EV
6,2019,2646,7,2653,EV
7,2019,2669,7,2676,EV
8,2019,2740,2,2742,EV
9,2019,2755,4,2759,EV
10,2019,2833,13,2846,EV
11,2019,2890,14,2904,EV
12,2019,2876,16,2892,EV
1,2020,2931,16,2947,EV
2,2020,2961,16,2977,EV
3,2020,2986,16,3002,EV
4,2020,2986,16,3002,EV
5,2020,2478,14,2492,EV
6,2020,2478,14,2492,EV
7,2020,2380,15,2395,EV
8,2020,2463,15,2478,EV
9,2020,2306,15,2321,EV
10,2021,102,4,106,EV
11,2021,116,4,120,EV
12,2021,119,4,123,EV
1,2022,129,4,133,EV
2,2022,131,1,132,EV
3,2022,128,1,129,EV
4,2022,128,1,129,EV
5,2022,126,1,127,EV
6,2022,127,1,128,EV
7,2022,124,3,127,EV
8,2022,128,3,131,EV
7,1994,225,0,225,F9
8,1994,279,0,279,F9
9,1994,309,0,309,F9
10,1994,324,0,324,F9
11,1994,331,0,331,F9
12,1994,327,0,327,F9
1,1995,320,0,320,F9
2,1995,326,20,346,F9
3,1995,318,20,338,F9
4,1995,318,20,338,F9
5,1995,279,75,354,F9
6,1995,293,96,389,F9
7,1995,330,72,402,F9
8,1995,355,70,425,F9
9,1995,317,71,388,F9
10,1995,338,43,381,F9
11,1995,393,39,432,F9
12,1995,405,42,447,F9
1,1996,407,43,450,F9
2,1996,421,43,464,F9
3,1996,456,77,533,F9
4,1996,504,79,583,F9
5,1996,526,83,609,F9
6,1996,543,78,621,F9
7,1996,568,90,658,F9
8,1996,606,105,711,F9
9,1996,620,106,726,F9
10,1996,613,105,718,F9
11,1996,608,104,712,F9
12,1996,606,108,714,F9
1,1997,609,102,711,F9
2,1997,615,98,713,F9
3,1997,630,108,738,F9
4,1997,661,108,769,F9
5,1997,694,104,798,F9
6,1997,694,104,798,F9
7,1997,694,122,816,F9
8,1997,744,125,869,F9
9,1997,744,125,869,F9
10,1997,756,132,888,F9
11,1997,756,132,888,F9
12,1997,752,146,898,F9
1,1998,740,149,889,F9
2,1998,758,153,911,F9
3,1998,760,166,926,F9
4,1998,745,162,907,F9
5,1998,750,175,925,F9
6,1998,754,197,951,F9
7,1998,754,197,951,F9
8,1998,803,234,1037,F9
9,1998,857,267,1124,F9
10,1998,898,304,1202,F9
11,1998,957,304,1261,F9
12,1998,941,295,1236,F9
1,1999,960,299,1259,F9
2,1999,1036,307,1343,F9
3,1999,1179,323,1502,F9
4,1999,1226,334,1560,F9
5,1999,1260,347,1607,F9
6,1999,1263,375,1638,F9
7,1999,1354,390,1744,F9
8,1999,1379,394,1773,F9
9,1999,1372,391,1763,F9
10,1999,1384,421,1805,F9
11,1999,1462,430,1892,F9
12,1999,1515,433,1948,F9
1,2000,1545,448,1993,F9
2,2000,1653,401,2054,F9
3,2000,1659,408,2067,F9
4,2000,1847,486,2333,F9
5,2000,1642,490,2132,F9
6,2000,1696,434,2130,F9
7,2000,1717,464,2181,F9
8,2000,1781,471,2252,F9
9,2000,1794,479,2273,F9
10,2000,1836,487,2323,F9
11,2000,1841,477,2318,F9
12,2000,1847,470,2317,F9
1,2001,1534,477,2011,F9
2,2001,1960,460,2420,F9
3,2001,1993,448,2441,F9
4,2001,1654,455,2109,F9
5,2001,2089,404,2493,F9
6,2001,2071,437,2508,F9
7,2001,2109,446,2555,F9
8,2001,2126,443,2569,F9
9,2001,2054,455,2509,F9
10,2001,1942,459,2401,F9
11,2001,1945,482,2427,F9
12,2001,1954,487,2441,F9
1,2002,2015,544,2559,F9
2,2002,2010,519,2529,F9
3,2002,2142,557,2699,F9
4,2002,2203,591,2794,F9
5,2002,2263,590,2853,F9
6,2002,2364,595,2959,F9
7,2002,2362,598,2960,F9
8,2002,2354,613,2967,F9
9,2002,2337,599,2936,F9
10,2002,2422,595,3017,F9
11,2002,2438,594,3032,F9
12,2002,3020,600,3620,F9
1,2003,2436,614,3050,F9
2,2003,2477,637,3114,F9
3,2003,2516,641,3157,F9
4,2003,2535,674,3209,F9
5,2003,2647,725,3372,F9
6,2003,2663,730,3393,F9
7,2003,2616,738,3354,F9
8,2003,2710,748,3458,F9
9,2003,2775,796,3571,F9
10,2003,2880,792,3672,F9
11,2003,2947,812,3759,F9
12,2003,2961,807,3768,F9
1,2004,3067,801,3868,F9
2,2004,3198,0,3198,F9
3,2004,3331,855,4186,F9
4,2004,3414,882,4296,F9
5,2004,3453,906,4359,F9
6,2004,3490,895,4385,F9
7,2004,3522,894,4416,F9
8,2004,3576,886,4462,F9
9,2004,3627,882,4509,F9
10,2004,3629,901,4530,F9
11,2004,3629,885,4514,F9
12,2004,3620,872,4492,F9
1,2005,3648,885,4533,F9
2,2005,3639,876,4515,F9
3,2005,3630,868,4498,F9
4,2005,3631,883,4514,F9
5,2005,3611,910,4521,F9
6,2005,3591,923,4514,F9
7,2005,3641,951,4592,F9
8,2005,3612,940,4552,F9
9,2005,3624,945,4569,F9
10,2005,3645,932,4577,F9
11,2005,3635,930,4565,F9
12,2005,3635,915,4550,F9
1,2006,3720,918,4638,F9
2,2006,3789,935,4724,F9
3,2006,3833,916,4749,F9
4,2006,3841,914,4755,F9
5,2006,3971,903,4874,F9
6,2006,4012,943,4955,F9
7,2006,4044,970,5014,F9
8,2006,4056,965,5021,F9
9,2006,4042,951,4993,F9
10,2006,4038,949,4987,F9
11,2006,4060,949,5009,F9
12,2006,4052,939,4991,F9
1,2007,4078,934,5012,F9
2,2007,4149,929,5078,F9
3,2007,4225,931,5156,F9
4,2007,4334,931,5265,F9
5,2007,4403,959,5362,F9
6,2007,4457,965,5422,F9
7,2007,4564,1024,5588,F9
8,2007,4605,1058,5663,F9
9,2007,4663,1086,5749,F9
10,2007,4648,1091,5739,F9
11,2007,4712,1070,5782,F9
12,2007,4694,1043,5737,F9
1,2008,4738,1071,5809,F9
2,2008,4717,1075,5792,F9
3,2008,4619,1052,5671,F9
4,2008,4569,1042,5611,F9
5,2008,4569,1048,5617,F9
6,2008,4439,1020,5459,F9
7,2008,4235,1013,5248,F9
8,2008,4098,957,5055,F9
9,2008,3953,1052,5005,F9
10,2008,3945,1030,4975,F9
11,2008,3914,1056,4970,F9
12,2008,3943,907,4850,F9
1,2009,3915,998,4913,F9
2,2009,3913,984,4897,F9
3,2009,3887,998,4885,F9
4,2009,3918,990,4908,F9
5,2009,3929,990,4919,F9
6,2009,3901,979,4880,F9
7,2009,3876,965,4841,F9
8,2009,3849,976,4825,F9
9,2009,3784,985,4769,F9
10,2009,3793,981,4774,F9
11,2009,3856,992,4848,F9
12,2009,4342,1380,5722,F9
1,2010,4429,1369,5798,F9
2,2010,4370,1381,5751,F9
3,2010,4257,1417,5674,F9
4,2010,4245,1349,5594,F9
5,2010,4299,1154,5453,F9
6,2010,4267,1132,5399,F9
7,2010,4268,1113,5381,F9
8,2010,4292,1109,5401,F9
9,2010,4311,1329,5640,F9
10,2010,4174,1330,5504,F9
11,2010,4303,1337,5640,F9
12,2010,4237,1319,5556,F9
1,2011,4233,1331,5564,F9
2,2011,4243,1321,5564,F9
3,2011,4247,1310,5557,F9
4,2011,4268,1321,5589,F9
5,2011,4292,1303,5595,F9
6,2011,4312,1307,5619,F9
7,2011,4299,1278,5577,F9
8,2011,4360,1267,5627,F9
9,2011,4286,1253,5539,F9
10,2011,4226,1218,5444,F9
11,2011,4071,1173,5244,F9
12,2011,4071,1173,5244,F9
1,2012,3960,1150,5110,F9
2,2012,3942,1131,5073,F9
3,2012,3877,1098,4975,F9
4,2012,3796,1069,4865,F9
5,2012,3724,1039,4763,F9
6,2012,3678,1028,4706,F9
7,2012,3621,1009,4630,F9
8,2012,3535,1042,4577,F9
9,2012,3517,1053,4570,F9
10,2012,3474,1066,4540,F9
11,2012,3418,1064,4482,F9
12,2012,3374,1048,4422,F9
1,2013,3343,1045,4388,F9
2,2013,3327,1046,4373,F9
3,2013,3302,1011,4313,F9
4,2013,3254,965,4219,F9
5,2013,3255,938,4193,F9
6,2013,3169,882,4051,F9
7,2013,3170,883,4053,F9
8,2013,3137,825,3962,F9
9,2013,3094,763,3857,F9
10,2013,3077,719,3796,F9
11,2013,3099,690,3789,F9
12,2013,3159,669,3828,F9
1,2014,3079,666,3745,F9
2,2014,3233,663,3896,F9
3,2014,3173,661,3834,F9
4,2014,3295,666,3961,F9
5,2014,3332,676,4008,F9
6,2014,3342,686,4028,F9
7,2014,3397,702,4099,F9
8,2014,3487,689,4176,F9
9,2014,3412,691,4103,F9
10,2014,3374,658,4032,F9
11,2014,3352,639,3991,F9
12,2014,3320,609,3929,F9
1,2015,3338,547,3885,F9
2,2015,3312,525,3837,F9
3,2015,2913,218,3131,F9
4,2015,2872,78,2950,F9
5,2015,2709,45,2754,F9
6,2015,2735,40,2775,F9
7,2015,2767,39,2806,F9
8,2015,2756,39,2795,F9
9,2015,2846,45,2891,F9
10,2015,2883,43,2926,F9
11,2015,2853,44,2897,F9
12,2015,2929,47,2976,F9
1,2016,2939,46,2985,F9
2,2016,2980,43,3023,F9
3,2016,2995,40,3035,F9
4,2016,3051,37,3088,F9
5,2016,3038,37,3075,F9
6,2016,3120,38,3158,F9
7,2016,3126,41,3167,F9
8,2016,3161,40,3201,F9
9,2016,3241,41,3282,F9
10,2016,3288,41,3329,F9
11,2016,3359,41,3400,F9
12,2016,3372,40,3412,F9
1,2017,3394,39,3433,F9
2,2017,3453,38,3491,F9
3,2017,3516,35,3551,F9
4,2017,3573,34,3607,F9
5,2017,3590,34,3624,F9
6,2017,3600,36,3636,F9
7,2017,3558,35,3593,F9
8,2017,3607,32,3639,F9
9,2017,3566,34,3600,F9
10,2017,3597,39,3636,F9
11,2017,3650,40,3690,F9
12,2017,3682,39,3721,F9
1,2018,3706,39,3745,F9
2,2018,3713,38,3751,F9
3,2018,3763,37,3800,F9
4,2018,3826,37,3863,F9
5,2018,3880,41,3921,F9
6,2018,3950,41,3991,F9
7,2018,3991,39,4030,F9
8,2018,4028,36,4064,F9
9,2018,4068,36,4104,F9
10,2018,4160,39,4199,F9
11,2018,4225,39,4264,F9
12,2018,4197,37,4234,F9
1,2019,4309,34,4343,F9
2,2019,4372,40,4412,F9
3,2019,4405,42,4447,F9
4,2019,4458,39,4497,F9
5,2019,4581,48,4629,F9
6,2019,4639,51,4690,F9
7,2019,4669,51,4720,F9
8,2019,4702,47,4749,F9
9,2019,4787,48,4835,F9
10,2019,4834,46,4880,F9
11,2019,4893,45,4938,F9
12,2019,4905,60,4965,F9
1,2020,4957,63,5020,F9
2,2020,5036,65,5101,F9
3,2020,5115,66,5181,F9
4,2020,5090,63,5153,F9
5,2020,5076,63,5139,F9
6,2020,5040,61,5101,F9
7,2020,5028,68,5096,F9
8,2020,5015,65,5080,F9
9,2020,4990,65,5055,F9
10,2020,4955,64,5019,F9
11,2020,4957,64,5021,F9
12,2020,4948,63,5011,F9
1,2021,4934,62,4996,F9
2,2021,4891,61,4952,F9
3,2021,4898,48,4946,F9
4,2021,4948,47,4995,F9
5,2021,4984,47,5031,F9
6,2021,5129,49,5178,F9
7,2021,5210,50,5260,F9
8,2021,5302,48,5350,F9
9,2021,5381,48,5429,F9
10,2021,5441,46,5487,F9
11,2021,5496,43,5539,F9
12,2021,5459,43,5502,F9
1,2022,5485,44,5529,F9
2,2022,5520,44,5564,F9
3,2022,5525,40,5565,F9
4,2022,5590,39,5629,F9
5,2022,5658,39,5697,F9
6,2022,5694,35,5729,F9
7,2022,5775,36,5811,F9
8,2022,5976,37,6013,F9
9,2022,6106,39,6145,F9
10,2022,6275,40,6315,F9
11,2022,6376,39,6415,F9
12,2022,6429,41,6470,F9
1,2023,6455,41,6496,F9
2,2023,6503,43,6546,F9
3,2023,6566,42,6608,F9
4,2023,6529,43,6572,F9
5,2023,6610,41,6651,F9
6,2023,6669,46,6715,F9
7,2023,6790,39,6829,F9
8,2023,6830,42,6872,F9
9,2023,6939,40,6979,F9
10,2023,7023,43,7066,F9
11,2023,7070,43,7113,F9
12,2023,7193,42,7235,F9
1,2024,7256,41,7297,F9
2,2024,7481,41,7522,F9
3,2024,7655,40,7695,F9
4,2024,7817,40,7857,F9
5,2024,7948,40,7988,F9
6,2024,8072,56,8128,F9
7,2024,8116,55,8171,F9
8,2024,8037,55,8092,F9
9,2024,7984,53,8037,F9
10,2024,7888,52,7940,F9
11,2024,7893,50,7943,F9
12,2024,7888,50,7938,F9
1,2025,7885,51,7936,F9
10,1994,93,2,95,FL
11,1994,109,2,111,FL
12,1994,93,2,95,FL
1,1995,190,2,192,FL
2,1995,181,0,181,FL
3,1995,194,0,194,FL
4,1995,204,6,210,FL
5,1995,227,9,236,FL
6,1995,215,23,238,FL
7,1995,225,39,264,FL
9,1995,314,47,361,FL
10,1995,275,55,330,FL
11,1995,299,57,356,FL
12,1995,315,57,372,FL
1,1996,348,36,384,FL
2,1996,370,58,428,FL
3,1996,399,73,472,FL
4,1996,400,106,506,FL
5,1996,427,58,485,FL
6,1996,428,70,498,FL
7,1996,461,69,530,FL
8,1996,421,82,503,FL
9,1996,444,81,525,FL
10,1996,448,80,528,FL
11,1996,433,71,504,FL
12,1996,454,73,527,FL
1,1997,466,71,537,FL
2,1997,491,95,586,FL
3,1997,466,71,537,FL
4,1997,527,166,693,FL
5,1997,485,145,630,FL
6,1997,471,127,598,FL
7,1997,496,80,576,FL
8,1997,509,69,578,FL
9,1997,510,77,587,FL
10,1997,501,70,571,FL
11,1997,520,81,601,FL
12,1997,545,74,619,FL
1,1998,558,89,647,FL
2,1998,498,36,534,FL
3,1998,488,29,517,FL
4,1998,2990,535,3525,FL
5,1998,3235,555,3790,FL
6,1998,3261,565,3826,FL
7,1998,3173,544,3717,FL
8,1998,3197,556,3753,FL
9,1998,3178,564,3742,FL
10,1998,3194,542,3736,FL
11,1998,3073,529,3602,FL
12,1998,2974,504,3478,FL
1,1999,2998,486,3484,FL
2,1999,2972,507,3479,FL
3,1999,3066,516,3582,FL
4,1999,3216,500,3716,FL
5,1999,3289,503,3792,FL
6,1999,3396,514,3910,FL
7,1999,3383,532,3915,FL
8,1999,3420,533,3953,FL
9,1999,3375,515,3890,FL
10,1999,3409,501,3910,FL
11,1999,3449,483,3932,FL
12,1999,3337,485,3822,FL
1,2000,3343,442,3785,FL
2,2000,3446,457,3903,FL
3,2000,3384,443,3827,FL
4,2000,3255,411,3666,FL
5,2000,3383,376,3759,FL
6,2000,3643,367,4010,FL
7,2000,3814,386,4200,FL
8,2000,3755,416,4171,FL
9,2000,3651,445,4096,FL
10,2000,3629,431,4060,FL
11,2000,3606,428,4034,FL
12,2000,3622,413,4035,FL
1,2001,3698,399,4097,FL
2,2001,3869,367,4236,FL
3,2001,3905,384,4289,FL
4,2001,3918,381,4299,FL
5,2001,4074,429,4503,FL
6,2001,4070,431,4501,FL
7,2001,3978,455,4433,FL
8,2001,3788,466,4254,FL
9,2001,3611,372,3983,FL
10,2001,3578,384,3962,FL
11,2001,3686,399,4085,FL
12,2001,3775,397,4172,FL
1,2002,3897,432,4329,FL
2,2002,4024,440,4464,FL
3,2002,4145,445,4590,FL
4,2002,4251,440,4691,FL
5,2002,4254,511,4765,FL
6,2002,4335,492,4827,FL
7,2002,4353,477,4830,FL
8,2002,4371,456,4827,FL
9,2002,4279,443,4722,FL
10,2002,4424,431,4855,FL
11,2002,4444,420,4864,FL
12,2002,4500,419,4919,FL
1,2003,4542,396,4938,FL
2,2003,4661,401,5062,FL
3,2003,4740,388,5128,FL
4,2003,4830,413,5243,FL
5,2003,4945,415,5360,FL
6,2003,5107,422,5529,FL
7,2003,5116,415,5531,FL
8,2003,5048,408,5456,FL
9,2003,5028,406,5434,FL
10,2003,5125,403,5528,FL
11,2003,5066,412,5478,FL
12,2003,5107,410,5517,FL
1,2004,5221,474,5695,FL
2,2004,5102,446,5548,FL
3,2004,5135,464,5599,FL
4,2004,5168,476,5644,FL
5,2004,5255,502,5757,FL
6,2004,5381,486,5867,FL
7,2004,5473,493,5966,FL
8,2004,5484,453,5937,FL
9,2004,5438,398,5836,FL
10,2004,5393,385,5778,FL
11,2004,5623,397,6020,FL
12,2004,5754,318,6072,FL
1,2005,5704,324,6028,FL
2,2005,5769,328,6097,FL
3,2005,5907,343,6250,FL
4,2005,5910,346,6256,FL
5,2005,5992,378,6370,FL
6,2005,6043,407,6450,FL
7,2005,6053,480,6533,FL
8,2005,6056,498,6554,FL
9,2005,6053,498,6551,FL
10,2005,6140,491,6631,FL
11,2005,6325,467,6792,FL
12,2005,6457,492,6949,FL
1,2006,6411,545,6956,FL
2,2006,6469,572,7041,FL
3,2006,6607,590,7197,FL
4,2006,6593,635,7228,FL
5,2006,6726,607,7333,FL
6,2006,6872,589,7461,FL
7,2006,6920,603,7523,FL
8,2006,6914,602,7516,FL
9,2006,6859,639,7498,FL
10,2006,7083,608,7691,FL
11,2006,7171,680,7851,FL
12,2006,7114,601,7715,FL
1,2007,7047,624,7671,FL
2,2007,7892,706,8598,FL
3,2007,7288,651,7939,FL
4,2007,7376,688,8064,FL
5,2007,7648,676,8324,FL
6,2007,7786,721,8507,FL
7,2007,7892,706,8598,FL
8,2007,7755,743,8498,FL
9,2007,7729,726,8455,FL
10,2007,7725,757,8482,FL
11,2007,7756,796,8552,FL
12,2007,7844,783,8627,FL
1,2008,7690,735,8425,FL
2,2008,7746,729,8475,FL
3,2008,7915,734,8649,FL
4,2008,7848,723,8571,FL
5,2008,7905,719,8624,FL
6,2008,7918,721,8639,FL
7,2008,7822,719,8541,FL
8,2008,7601,701,8302,FL
9,2008,7037,669,7706,FL
10,2008,7008,667,7675,FL
11,2008,6992,677,7669,FL
12,2008,7153,672,7825,FL
1,2009,7306,650,7956,FL
2,2009,7501,681,8182,FL
3,2009,7512,676,8188,FL
4,2009,7551,657,8208,FL
5,2009,7792,643,8435,FL
6,2009,7883,633,8516,FL
7,2009,7814,615,8429,FL
8,2009,7705,630,8335,FL
9,2009,7405,624,8029,FL
10,2009,7437,631,8068,FL
11,2009,7487,637,8124,FL
12,2009,7519,650,8169,FL
1,2010,7407,664,8071,FL
2,2010,7483,700,8183,FL
3,2010,7453,697,8150,FL
4,2010,7423,711,8134,FL
5,2010,7586,738,8324,FL
6,2010,7724,717,8441,FL
7,2010,7664,714,8378,FL
8,2010,7597,699,8296,FL
9,2010,7398,688,8086,FL
10,2010,7423,688,8111,FL
11,2010,7537,673,8210,FL
12,2010,7652,679,8331,FL
1,2011,7506,688,8194,FL
2,2011,7579,669,8248,FL
3,2011,7649,644,8293,FL
4,2011,7749,627,8376,FL
5,2011,7765,616,8381,FL
6,2011,7866,601,8467,FL
7,2011,7907,605,8512,FL
8,2011,7864,612,8476,FL
9,2011,7644,576,8220,FL
10,2011,7669,575,8244,FL
11,2011,7732,562,8294,FL
12,2011,7756,531,8287,FL
1,2012,7232,513,7745,FL
2,2012,7212,492,7704,FL
3,2012,7043,479,7522,FL
7,1998,24,0,24,G4
8,1998,24,0,24,G4
9,1998,25,0,25,G4
10,1998,26,0,26,G4
11,1998,25,0,25,G4
12,1998,24,0,24,G4
1,1999,25,0,25,G4
2,1999,26,0,26,G4
3,1999,29,0,29,G4
4,1999,29,0,29,G4
5,1999,38,7,45,G4
6,1999,47,19,66,G4
7,1999,47,19,66,G4
8,1999,49,19,68,G4
9,1999,50,29,79,G4
10,1999,52,31,83,G4
11,1999,64,25,89,G4
12,1999,65,32,97,G4
1,2000,63,32,95,G4
2,2000,63,36,99,G4
3,2000,72,27,99,G4
4,2000,92,11,103,G4
5,2000,76,30,106,G4
6,2000,81,32,113,G4
7,2000,100,48,148,G4
8,2000,103,49,152,G4
9,2000,100,54,154,G4
10,2000,107,52,159,G4
11,2000,107,52,159,G4
12,2000,42,6,48,G4
1,2001,39,7,46,G4
2,2001,41,8,49,G4
3,2001,39,8,47,G4
4,2001,39,8,47,G4
5,2001,39,8,47,G4
6,2001,43,6,49,G4
7,2001,45,10,55,G4
8,2001,49,9,58,G4
9,2001,47,9,56,G4
10,2001,49,7,56,G4
11,2001,49,7,56,G4
12,2001,47,9,56,G4
1,2002,66,13,79,G4
2,2002,68,12,80,G4
3,2002,73,13,86,G4
4,2002,77,16,93,G4
5,2002,80,16,96,G4
6,2002,75,17,92,G4
7,2002,81,21,102,G4
8,2002,102,21,123,G4
9,2002,89,24,113,G4
10,2002,102,24,126,G4
11,2002,103,19,122,G4
12,2002,96,21,117,G4
1,2003,102,23,125,G4
2,2003,102,24,126,G4
3,2003,97,23,120,G4
4,2003,129,24,153,G4
5,2003,135,25,160,G4
6,2003,160,30,190,G4
7,2003,152,75,227,G4
8,2003,180,79,259,G4
9,2003,180,79,259,G4
10,2003,243,45,288,G4
11,2003,234,38,272,G4
12,2003,254,55,309,G4
1,2004,263,51,314,G4
2,2004,265,59,324,G4
3,2004,295,61,356,G4
4,2004,286,57,343,G4
5,2004,303,55,358,G4
6,2004,302,65,367,G4
7,2004,323,84,407,G4
8,2004,311,79,390,G4
9,2004,324,82,406,G4
10,2004,317,84,401,G4
11,2004,326,88,414,G4
12,2004,339,93,432,G4
1,2005,341,92,433,G4
2,2005,348,92,440,G4
3,2005,384,100,484,G4
4,2005,371,111,482,G4
5,2005,393,117,510,G4
6,2005,399,113,512,G4
7,2005,406,101,507,G4
8,2005,407,102,509,G4
9,2005,436,74,510,G4
10,2005,470,73,543,G4
11,2005,486,136,622,G4
12,2005,517,76,593,G4
1,2006,531,171,702,G4
2,2006,553,195,748,G4
3,2006,574,205,779,G4
4,2006,579,224,803,G4
5,2006,612,227,839,G4
6,2006,616,246,862,G4
7,2006,625,248,873,G4
8,2006,646,278,924,G4
9,2006,646,281,927,G4
10,2006,685,285,970,G4
11,2006,710,281,991,G4
12,2006,701,289,990,G4
1,2007,727,281,1008,G4
2,2007,751,288,1039,G4
3,2007,766,297,1063,G4
4,2007,780,302,1082,G4
5,2007,796,321,1117,G4
6,2007,791,320,1111,G4
7,2007,793,346,1139,G4
8,2007,828,339,1167,G4
9,2007,855,360,1215,G4
10,2007,895,367,1262,G4
11,2007,954,372,1326,G4
12,2007,985,390,1375,G4
1,2008,986,377,1363,G4
2,2008,1028,383,1411,G4
3,2008,1082,395,1477,G4
4,2008,1110,395,1505,G4
5,2008,1107,385,1492,G4
6,2008,1110,378,1488,G4
7,2008,1116,407,1523,G4
8,2008,1108,397,1505,G4
9,2008,1086,392,1478,G4
10,2008,1113,387,1500,G4
11,2008,1122,427,1549,G4
12,2008,1135,425,1560,G4
1,2009,1138,429,1567,G4
2,2009,1177,442,1619,G4
3,2009,1199,439,1638,G4
4,2009,1235,437,1672,G4
5,2009,1239,443,1682,G4
6,2009,1262,446,1708,G4
7,2009,1269,447,1716,G4
8,2009,1272,452,1724,G4
9,2009,1289,460,1749,G4
10,2009,1284,461,1745,G4
11,2009,1315,454,1769,G4
12,2009,1339,452,1791,G4
1,2010,1328,406,1734,G4
2,2010,1362,396,1758,G4
3,2010,1401,392,1793,G4
4,2010,1429,388,1817,G4
5,2010,1442,374,1816,G4
6,2010,1443,380,1823,G4
7,2010,1443,374,1817,G4
8,2010,1436,376,1812,G4
9,2010,1433,370,1803,G4
10,2010,1445,363,1808,G4
11,2010,1430,368,1798,G4
12,2010,1428,361,1789,G4
1,2011,1427,399,1826,G4
2,2011,1449,340,1789,G4
3,2011,1443,331,1774,G4
4,2011,1455,316,1771,G4
5,2011,1418,225,1643,G4
6,2011,1438,256,1694,G4
7,2011,1425,229,1654,G4
8,2011,1432,230,1662,G4
9,2011,1428,234,1662,G4
10,2011,1445,235,1680,G4
11,2011,1450,224,1674,G4
12,2011,1479,222,1701,G4
1,2012,1494,225,1719,G4
2,2012,1535,225,1760,G4
3,2012,1584,222,1806,G4
4,2012,1615,226,1841,G4
5,2012,1625,215,1840,G4
6,2012,1638,211,1849,G4
7,2012,1644,204,1848,G4
8,2012,1644,203,1847,G4
9,2012,1662,213,1875,G4
10,2012,1657,244,1901,G4
11,2012,1655,247,1902,G4
12,2012,1693,245,1938,G4
1,2013,1685,246,1931,G4
2,2013,1733,267,2000,G4
3,2013,1731,296,2027,G4
4,2013,1751,295,2046,G4
5,2013,1750,312,2062,G4
6,2013,1758,311,2069,G4
7,2013,1875,300,2175,G4
8,2013,1787,320,2107,G4
9,2013,1831,333,2164,G4
10,2013,1847,323,2170,G4
11,2013,1880,335,2215,G4
12,2013,1894,341,2235,G4
1,2014,1907,346,2253,G4
2,2014,1960,347,2307,G4
3,2014,1963,333,2296,G4
4,2014,1924,329,2253,G4
5,2014,1990,316,2306,G4
6,2014,2060,347,2407,G4
7,2014,2059,336,2395,G4
8,2014,2084,328,2412,G4
9,2014,2150,122,2272,G4
10,2014,2172,326,2498,G4
11,2014,2235,326,2561,G4
12,2014,2245,319,2564,G4
1,2015,2237,320,2557,G4
2,2015,2304,311,2615,G4
3,2015,2292,302,2594,G4
4,2015,2292,300,2592,G4
5,2015,2371,298,2669,G4
6,2015,2394,318,2712,G4
7,2015,2406,309,2715,G4
8,2015,2466,307,2773,G4
9,2015,2494,312,2806,G4
10,2015,2570,333,2903,G4
11,2015,2570,333,2903,G4
12,2015,2674,337,3011,G4
1,2016,2729,330,3059,G4
2,2016,2828,359,3187,G4
3,2016,2844,360,3204,G4
4,2016,2919,353,3272,G4
5,2016,3024,367,3391,G4
6,2016,3041,364,3405,G4
7,2016,3241,364,3605,G4
8,2016,3063,356,3419,G4
9,2016,3095,376,3471,G4
10,2016,3154,386,3540,G4
11,2016,3041,364,3405,G4
12,2016,3235,354,3589,G4
1,2017,3253,351,3604,G4
2,2017,3311,354,3665,G4
3,2017,3344,374,3718,G4
4,2017,3556,370,3926,G4
5,2017,3424,374,3798,G4
6,2017,3432,383,3815,G4
7,2017,3467,379,3846,G4
8,2017,3485,421,3906,G4
9,2017,3492,415,3907,G4
10,2017,3538,411,3949,G4
11,2017,3560,400,3960,G4
12,2017,3545,406,3951,G4
1,2018,3541,415,3956,G4
2,2018,3576,414,3990,G4
3,2018,3566,420,3986,G4
4,2018,3589,407,3996,G4
5,2018,3622,430,4052,G4
6,2018,3619,441,4060,G4
7,2018,3629,439,4068,G4
8,2018,3643,436,4079,G4
9,2018,3622,426,4048,G4
10,2018,3643,425,4068,G4
11,2018,3646,435,4081,G4
12,2018,3643,516,4159,G4
1,2019,3526,435,3961,G4
2,2019,3636,430,4066,G4
3,2019,3615,442,4057,G4
4,2019,3644,458,4102,G4
5,2019,3676,448,4124,G4
6,2019,3729,462,4191,G4
7,2019,3711,470,4181,G4
8,2019,3748,445,4193,G4
9,2019,3824,455,4279,G4
10,2019,3896,456,4352,G4
11,2019,3926,461,4387,G4
12,2019,3908,457,4365,G4
1,2020,3935,459,4394,G4
2,2020,4001,477,4478,G4
3,2020,4070,417,4487,G4
4,2020,4084,413,4497,G4
5,2020,4069,406,4475,G4
6,2020,4036,400,4436,G4
7,2020,4006,409,4415,G4
8,2020,3987,412,4399,G4
9,2020,3976,414,4390,G4
10,2020,3730,422,4152,G4
11,2020,3756,418,4174,G4
12,2020,3748,409,4157,G4
1,2021,3746,409,4155,G4
2,2021,3756,420,4176,G4
3,2021,3748,424,4172,G4
4,2021,3774,421,4195,G4
5,2021,3833,468,4301,G4
6,2021,3872,477,4349,G4
7,2021,3923,494,4417,G4
8,2021,3976,513,4489,G4
9,2021,3973,539,4512,G4
10,2021,4052,537,4589,G4
11,2021,4105,560,4665,G4
12,2021,4157,550,4707,G4
1,2022,4235,563,4798,G4
2,2022,4332,580,4912,G4
3,2022,4403,578,4981,G4
4,2022,4520,566,5086,G4
5,2022,4656,701,5357,G4
6,2022,4810,740,5550,G4
7,2022,4811,725,5536,G4
8,2022,4838,703,5541,G4
9,2022,4931,708,5639,G4
10,2022,4961,694,5655,G4
11,2022,5004,662,5666,G4
12,2022,4982,648,5630,G4
1,2023,5000,670,5670,G4
2,2023,4994,672,5666,G4
3,2023,4974,672,5646,G4
4,2023,5007,696,5703,G4
5,2023,5088,731,5819,G4
6,2023,5060,751,5811,G4
7,2023,5099,735,5834,G4
8,2023,5116,727,5843,G4
9,2023,5177,802,5979,G4
10,2023,5199,835,6034,G4
11,2023,5230,845,6075,G4
12,2023,5226,834,6060,G4
1,2024,5363,897,6260,G4
2,2024,5438,973,6411,G4
3,2024,5453,996,6449,G4
4,2024,5444,993,6437,G4
5,2024,5499,994,6493,G4
6,2024,5493,1000,6493,G4
7,2024,5449,975,6424,G4
8,2024,5426,938,6364,G4
9,2024,5382,889,6271,G4
10,2024,5455,933,6388,G4
11,2024,5533,964,6497,G4
12,2024,5516,950,6466,G4
1,2025,5511,947,6458,G4
1,1990,2416,477,2893,HA
2,1990,2476,469,2945,HA
3,1990,2557,573,3130,HA
4,1990,2468,460,2928,HA
5,1990,2467,463,2930,HA
6,1990,2473,445,2918,HA
7,1990,2483,474,2957,HA
8,1990,2436,461,2897,HA
9,1990,2365,379,2744,HA
10,1990,2331,362,2693,HA
11,1990,2323,351,2674,HA
12,1990,2294,346,2640,HA
1,1991,2270,353,2623,HA
2,1991,2260,356,2616,HA
3,1991,2260,355,2615,HA
4,1991,2269,396,2665,HA
5,1991,2291,403,2694,HA
6,1991,2308,403,2711,HA
7,1991,2332,390,2722,HA
8,1991,2334,390,2724,HA
9,1991,2328,379,2707,HA
10,1991,2314,372,2686,HA
11,1991,2315,378,2693,HA
12,1991,2322,380,2702,HA
1,1992,2322,386,2708,HA
2,1992,2328,415,2743,HA
3,1992,2328,415,2743,HA
4,1992,2394,429,2823,HA
5,1992,2425,447,2872,HA
6,1992,2465,460,2925,HA
7,1992,2507,475,2982,HA
8,1992,2520,452,2972,HA
9,1992,2525,411,2936,HA
10,1992,2519,407,2926,HA
11,1992,2524,389,2913,HA
12,1992,2502,389,2891,HA
1,1993,2413,369,2782,HA
2,1993,2253,352,2605,HA
3,1993,2239,348,2587,HA
4,1993,2239,346,2585,HA
5,1993,2233,348,2581,HA
6,1993,2261,394,2655,HA
7,1993,2275,336,2611,HA
8,1993,2245,345,2590,HA
9,1993,2028,344,2372,HA
10,1993,1985,349,2334,HA
11,1993,1955,359,2314,HA
12,1993,1943,351,2294,HA
1,1994,1946,342,2288,HA
2,1994,2128,339,2467,HA
3,1994,2119,342,2461,HA
4,1994,2121,353,2474,HA
5,1994,2139,393,2532,HA
6,1994,2162,399,2561,HA
7,1994,2178,383,2561,HA
8,1994,2158,407,2565,HA
9,1994,2131,374,2505,HA
10,1994,2093,377,2470,HA
11,1994,2085,369,2454,HA
12,1994,2097,360,2457,HA
1,1995,2105,355,2460,HA
2,1995,2106,349,2455,HA
3,1995,2089,346,2435,HA
4,1995,2056,345,2401,HA
5,1995,2095,359,2454,HA
6,1995,2093,374,2467,HA
7,1995,2095,368,2463,HA
8,1995,2094,359,2453,HA
9,1995,2073,337,2410,HA
10,1995,2076,337,2413,HA
11,1995,2065,350,2415,HA
12,1995,2053,247,2300,HA
1,1996,2051,347,2398,HA
2,1996,2048,345,2393,HA
3,1996,2049,352,2401,HA
4,1996,2049,365,2414,HA
5,1996,2073,389,2462,HA
6,1996,2072,407,2479,HA
7,1996,2084,388,2472,HA
8,1996,2078,384,2462,HA
9,1996,2076,371,2447,HA
10,1996,2084,369,2453,HA
11,1996,2096,365,2461,HA
12,1996,2163,360,2523,HA
1,1997,2162,354,2516,HA
2,1997,2163,353,2516,HA
3,1997,2169,346,2515,HA
4,1997,2162,352,2514,HA
5,1997,2165,378,2543,HA
6,1997,2171,397,2568,HA
7,1997,2169,410,2579,HA
8,1997,2169,401,2570,HA
9,1997,2168,405,2573,HA
10,1997,2168,391,2559,HA
11,1997,2165,389,2554,HA
12,1997,2172,379,2551,HA
1,1998,2170,389,2559,HA
2,1998,2167,388,2555,HA
3,1998,2170,405,2575,HA
4,1998,2164,400,2564,HA
5,1998,2196,426,2622,HA
6,1998,2204,451,2655,HA
7,1998,2215,491,2706,HA
8,1998,2220,482,2702,HA
9,1998,2238,437,2675,HA
10,1998,2240,456,2696,HA
11,1998,2239,448,2687,HA
12,1998,2245,452,2697,HA
1,1999,2256,444,2700,HA
2,1999,2327,421,2748,HA
3,1999,2412,437,2849,HA
4,1999,2440,467,2907,HA
5,1999,2484,572,3056,HA
6,1999,2534,618,3152,HA
7,1999,2551,616,3167,HA
8,1999,2577,613,3190,HA
9,1999,2603,549,3152,HA
10,1999,2612,543,3155,HA
11,1999,2655,547,3202,HA
12,1999,2569,522,3091,HA
1,2000,2702,530,3232,HA
2,2000,2754,517,3271,HA
3,2000,2780,535,3315,HA
4,2000,2795,543,3338,HA
5,2000,2842,594,3436,HA
6,2000,2879,591,3470,HA
7,2000,2890,605,3495,HA
8,2000,2889,598,3487,HA
9,2000,2887,559,3446,HA
10,2000,2871,547,3418,HA
11,2000,2849,560,3409,HA
12,2000,2874,561,3435,HA
1,2001,2876,561,3437,HA
2,2001,2878,544,3422,HA
3,2001,2874,548,3422,HA
4,2001,2902,561,3463,HA
5,2001,2931,586,3517,HA
6,2001,2943,595,3538,HA
7,2001,2947,592,3539,HA
8,2001,2960,580,3540,HA
9,2001,2659,481,3140,HA
10,2001,2596,497,3093,HA
11,2001,2573,503,3076,HA
12,2001,2572,497,3069,HA
1,2002,2583,492,3075,HA
2,2002,2581,503,3084,HA
3,2002,2573,485,3058,HA
4,2002,2570,496,3066,HA
5,2002,2706,478,3184,HA
6,2002,2785,536,3321,HA
7,2002,2793,581,3374,HA
8,2002,2777,605,3382,HA
9,2002,2775,621,3396,HA
10,2002,2778,589,3367,HA
11,2002,2754,573,3327,HA
12,2002,2719,504,3223,HA
1,2003,2801,510,3311,HA
2,2003,2773,512,3285,HA
3,2003,2684,536,3220,HA
4,2003,2665,548,3213,HA
5,2003,2618,640,3258,HA
6,2003,2642,634,3276,HA
7,2003,2654,639,3293,HA
8,2003,2637,673,3310,HA
9,2003,2590,654,3244,HA
10,2003,2592,660,3252,HA
11,2003,2634,668,3302,HA
12,2003,2625,685,3310,HA
1,2004,2631,646,3277,HA
2,2004,2649,642,3291,HA
3,2004,2619,679,3298,HA
4,2004,2635,668,3303,HA
5,2004,2663,693,3356,HA
6,2004,2712,677,3389,HA
7,2004,2702,699,3401,HA
8,2004,2687,688,3375,HA
9,2004,2673,671,3344,HA
10,2004,2664,676,3340,HA
11,2004,2710,675,3385,HA
12,2004,3685,686,4371,HA
1,2005,2673,671,3344,HA
2,2005,2675,684,3359,HA
3,2005,2670,669,3339,HA
4,2005,2677,674,3351,HA
5,2005,2679,655,3334,HA
6,2005,2698,658,3356,HA
7,2005,2711,659,3370,HA
8,2005,2711,694,3405,HA
9,2005,2700,719,3419,HA
10,2005,2709,760,3469,HA
11,2005,2711,750,3461,HA
12,2005,2689,765,3454,HA
1,2006,2663,753,3416,HA
2,2006,2641,765,3406,HA
3,2006,2663,758,3421,HA
4,2006,2674,767,3441,HA
5,2006,2679,778,3457,HA
6,2006,2671,779,3450,HA
7,2006,2667,760,3427,HA
8,2006,2689,762,3451,HA
9,2006,2714,783,3497,HA
10,2006,2611,759,3370,HA
11,2006,2719,782,3501,HA
12,2006,2742,832,3574,HA
1,2007,2774,811,3585,HA
2,2007,2778,815,3593,HA
3,2007,2773,837,3610,HA
4,2007,2772,826,3598,HA
5,2007,2727,805,3532,HA
6,2007,2675,806,3481,HA
7,2007,2678,802,3480,HA
8,2007,2669,792,3461,HA
9,2007,2663,775,3438,HA
10,2007,2640,791,3431,HA
11,2007,2640,791,3431,HA
12,2007,2650,795,3445,HA
1,2008,2649,761,3410,HA
2,2008,2674,763,3437,HA
3,2008,2695,805,3500,HA
4,2008,2695,763,3458,HA
5,2008,2723,868,3591,HA
6,2008,2774,900,3674,HA
7,2008,2821,894,3715,HA
8,2008,2808,894,3702,HA
9,2008,2816,876,3692,HA
10,2008,2911,883,3794,HA
11,2008,2818,866,3684,HA
12,2008,2817,890,3707,HA
1,2009,2821,883,3704,HA
2,2009,2828,875,3703,HA
3,2009,2836,881,3717,HA
4,2009,2901,888,3789,HA
5,2009,2924,812,3736,HA
6,2009,2946,809,3755,HA
7,2009,2955,825,3780,HA
8,2009,2946,813,3759,HA
9,2009,2960,820,3780,HA
10,2009,2960,830,3790,HA
11,2009,2982,839,3821,HA
12,2009,2988,856,3844,HA
1,2010,2994,863,3857,HA
2,2010,2994,860,3854,HA
3,2010,2997,879,3876,HA
4,2010,2990,880,3870,HA
5,2010,2999,904,3903,HA
6,2010,3032,908,3940,HA
7,2010,3039,913,3952,HA
8,2010,3058,909,3967,HA
9,2010,3055,903,3958,HA
10,2010,3064,921,3985,HA
11,2010,3089,932,4021,HA
12,2010,3094,929,4023,HA
1,2011,3070,930,4000,HA
2,2011,3066,933,3999,HA
3,2011,3084,940,4024,HA
4,2011,3136,920,4056,HA
5,2011,3176,914,4090,HA
6,2011,3240,906,4146,HA
7,2011,3240,906,4146,HA
8,2011,3256,919,4175,HA
9,2011,3273,949,4222,HA
10,2011,3278,949,4227,HA
11,2011,3309,946,4255,HA
12,2011,3350,964,4314,HA
1,2012,3357,964,4321,HA
2,2012,3476,962,4438,HA
3,2012,3496,955,4451,HA
4,2012,3578,942,4520,HA
5,2012,3649,953,4602,HA
6,2012,3653,971,4624,HA
7,2012,3684,962,4646,HA
8,2012,3757,973,4730,HA
9,2012,3783,973,4756,HA
10,2012,3815,1002,4817,HA
11,2012,3832,1039,4871,HA
12,2012,3866,1040,4906,HA
1,2013,3877,1032,4909,HA
2,2013,3940,1025,4965,HA
3,2013,3939,1023,4962,HA
4,2013,4045,1013,5058,HA
5,2013,4117,1002,5119,HA
6,2013,4154,1003,5157,HA
7,2013,4181,1002,5183,HA
8,2013,4204,1011,5215,HA
9,2013,4213,1020,5233,HA
10,2013,4231,1018,5249,HA
11,2013,4234,1020,5254,HA
12,2013,4237,1012,5249,HA
1,2014,4252,1043,5295,HA
2,2014,4258,1053,5311,HA
3,2014,4269,1070,5339,HA
4,2014,4264,1081,5345,HA
5,2014,4265,1098,5363,HA
6,2014,4262,1100,5362,HA
7,2014,4252,1097,5349,HA
8,2014,4259,1087,5346,HA
9,2014,4259,1072,5331,HA
10,2014,4263,1075,5338,HA
11,2014,4304,1080,5384,HA
12,2014,4311,1069,5380,HA
1,2015,4314,1071,5385,HA
2,2015,4318,1063,5381,HA
3,2015,4322,1049,5371,HA
4,2015,4344,1035,5379,HA
5,2015,4395,1044,5439,HA
6,2015,4400,1039,5439,HA
7,2015,4421,1033,5454,HA
8,2015,4436,1029,5465,HA
9,2015,4444,1031,5475,HA
10,2015,4460,1037,5497,HA
11,2015,4477,1041,5518,HA
12,2015,4499,1049,5548,HA
1,2016,4538,1062,5600,HA
2,2016,4598,1071,5669,HA
3,2016,4628,1093,5721,HA
4,2016,4665,1118,5783,HA
5,2016,4736,1155,5891,HA
6,2016,4760,1185,5945,HA
7,2016,4796,1195,5991,HA
8,2016,4840,1219,6059,HA
9,2016,4859,1215,6074,HA
10,2016,4892,1217,6109,HA
11,2016,4948,1243,6191,HA
12,2016,4952,1247,6199,HA
1,2017,4978,1244,6222,HA
2,2017,4985,1233,6218,HA
3,2017,5005,1229,6234,HA
4,2017,5008,1256,6264,HA
5,2017,5040,1298,6338,HA
6,2017,5053,1303,6356,HA
7,2017,5084,1307,6391,HA
8,2017,5147,1315,6462,HA
9,2017,5162,1329,6491,HA
10,2017,5223,1383,6606,HA
11,2017,5261,1399,6660,HA
12,2017,5296,1446,6742,HA
1,2018,5370,1439,6809,HA
2,2018,5464,1432,6896,HA
3,2018,5486,1423,6909,HA
4,2018,5572,1432,7004,HA
5,2018,5680,1438,7118,HA
6,2018,5686,1456,7142,HA
7,2018,5712,1447,7159,HA
8,2018,5692,1453,7145,HA
9,2018,5698,1454,7152,HA
10,2018,5723,1464,7187,HA
11,2018,5733,1488,7221,HA
12,2018,5728,1516,7244,HA
1,2019,5743,1507,7250,HA
2,2019,5772,1500,7272,HA
3,2019,5812,1487,7299,HA
4,2019,5823,1471,7294,HA
5,2019,5843,1469,7312,HA
6,2019,5895,1465,7360,HA
7,2019,5913,1443,7356,HA
8,2019,5906,1443,7349,HA
9,2019,5925,1464,7389,HA
10,2019,5945,1466,7411,HA
11,2019,5992,1461,7453,HA
12,2019,6011,1426,7437,HA
1,2020,6024,1423,7447,HA
2,2020,6067,1435,7502,HA
3,2020,6076,1416,7492,HA
4,2020,6065,1411,7476,HA
5,2020,6057,1387,7444,HA
6,2020,6039,1379,7418,HA
7,2020,6028,1376,7404,HA
8,2020,5923,1369,7292,HA
9,2020,5846,1241,7087,HA
10,2020,5231,1289,6520,HA
11,2020,4513,530,5043,HA
12,2020,4572,706,5278,HA
1,2021,4793,691,5484,HA
2,2021,5329,685,6014,HA
3,2021,5351,698,6049,HA
4,2021,4883,846,5729,HA
5,2021,5064,899,5963,HA
6,2021,5104,929,6033,HA
7,2021,5121,957,6078,HA
8,2021,5141,965,6106,HA
9,2021,5493,962,6455,HA
10,2021,5536,987,6523,HA
11,2021,5556,1012,6568,HA
12,2021,5585,1014,6599,HA
1,2022,5549,999,6548,HA
2,2022,5508,1007,6515,HA
3,2022,5569,1017,6586,HA
4,2022,5705,997,6702,HA
5,2022,5811,998,6809,HA
6,2022,5912,1016,6928,HA
7,2022,5990,1023,7013,HA
8,2022,6001,1034,7035,HA
9,2022,6108,1002,7110,HA
10,2022,6156,1002,7158,HA
11,2022,6195,880,7075,HA
12,2022,6235,872,7107,HA
1,2023,6273,909,7182,HA
2,2023,6317,903,7220,HA
3,2023,6332,886,7218,HA
4,2023,6369,866,7235,HA
5,2023,6389,878,7267,HA
6,2023,6448,861,7309,HA
7,2023,6479,866,7345,HA
8,2023,6490,880,7370,HA
9,2023,6494,853,7347,HA
10,2023,6510,862,7372,HA
11,2023,6535,860,7395,HA
12,2023,6522,840,7362,HA
1,2024,6520,845,7365,HA
2,2024,6536,838,7374,HA
3,2024,6535,851,7386,HA
4,2024,6545,835,7380,HA
5,2024,6546,846,7392,HA
6,2024,6582,834,7416,HA
7,2024,6597,840,7437,HA
8,2024,6595,825,7420,HA
9,2024,6588,822,7410,HA
10,2024,6573,823,7396,HA
11,2024,6560,828,7388,HA
12,2024,6541,821,7362,HA
1,2025,6518,834,7352,HA
10,1991,1591,160,1751,MQ
11,1991,1641,165,1806,MQ
12,1991,1636,197,1833,MQ
1,1992,1733,190,1923,MQ
2,1992,1648,192,1840,MQ
3,1992,1640,185,1825,MQ
4,1992,1654,171,1825,MQ
5,1992,1648,167,1815,MQ
6,1992,1643,162,1805,MQ
7,1992,1643,165,1808,MQ
8,1992,1650,160,1810,MQ
9,1992,1648,173,1821,MQ
10,1992,1669,185,1854,MQ
11,1992,1684,201,1885,MQ
12,1992,1663,214,1877,MQ
1,1993,4219,481,4700,MQ
2,1993,2540,277,2817,MQ
3,1993,2594,265,2859,MQ
4,1993,2609,240,2849,MQ
5,1993,2665,229,2894,MQ
6,1993,2661,223,2884,MQ
7,1993,2686,234,2920,MQ
8,1993,2791,233,3024,MQ
9,1993,2769,266,3035,MQ
10,1993,2747,285,3032,MQ
11,1993,2823,290,3113,MQ
12,1993,2841,284,3125,MQ
1,1994,2883,301,3184,MQ
2,1994,2902,304,3206,MQ
3,1994,2880,297,3177,MQ
4,1994,2877,321,3198,MQ
5,1994,2852,345,3197,MQ
6,1994,2924,329,3253,MQ
7,1994,2983,348,3331,MQ
8,1994,2991,369,3360,MQ
9,1994,3022,378,3400,MQ
10,1994,3032,338,3370,MQ
11,1994,3020,404,3424,MQ
12,1994,3005,410,3415,MQ
1,1995,2959,398,3357,MQ
2,1995,2966,403,3369,MQ
3,1995,3025,411,3436,MQ
4,1995,3150,434,3584,MQ
5,1995,3303,459,3762,MQ
6,1995,3381,474,3855,MQ
8,1995,3511,523,4034,MQ
9,1995,3517,526,4043,MQ
10,1995,3542,551,4093,MQ
11,1995,3593,555,4148,MQ
12,1995,3667,546,4213,MQ
1,1996,3678,508,4186,MQ
2,1996,3689,535,4224,MQ
3,1996,3739,518,4257,MQ
4,1996,3692,517,4209,MQ
5,1996,3711,522,4233,MQ
6,1996,3710,500,4210,MQ
7,1996,3675,487,4162,MQ
8,1996,3663,500,4163,MQ
9,1996,3653,500,4153,MQ
10,1996,3664,508,4172,MQ
11,1996,3678,512,4190,MQ
12,1996,3739,510,4249,MQ
1,1997,3727,512,4239,MQ
2,1997,3720,525,4245,MQ
3,1997,3541,501,4042,MQ
4,1997,3636,361,3997,MQ
5,1997,3508,541,4049,MQ
6,1997,3532,530,4062,MQ
7,1997,3518,526,4044,MQ
8,1997,3596,537,4133,MQ
9,1997,3593,534,4127,MQ
10,1997,3627,518,4145,MQ
11,1997,3627,527,4154,MQ
12,1997,3684,531,4215,MQ
1,1998,3710,528,4238,MQ
2,1998,3690,547,4237,MQ
3,1998,3542,501,4043,MQ
4,1998,3733,529,4262,MQ
5,1998,5260,955,6215,MQ
6,1998,6590,1218,7808,MQ
7,1998,6630,1215,7845,MQ
8,1998,6692,1208,7900,MQ
9,1998,6660,1179,7839,MQ
10,1998,6728,1193,7921,MQ
11,1998,6698,1204,7902,MQ
12,1998,6648,1235,7883,MQ
1,1999,6718,1195,7913,MQ
2,1999,6718,1211,7929,MQ
3,1999,6761,1227,7988,MQ
4,1999,6801,1232,8033,MQ
5,1999,6856,1258,8114,MQ
6,1999,6909,1254,8163,MQ
7,1999,7093,1295,8388,MQ
8,1999,7103,1271,8374,MQ
9,1999,7192,1280,8472,MQ
10,1999,7222,1288,8510,MQ
11,1999,7310,1320,8630,MQ
12,1999,7471,1124,8595,MQ
1,2000,7470,1118,8588,MQ
2,2000,7587,1150,8737,MQ
3,2000,7623,1154,8777,MQ
4,2000,7919,1234,9153,MQ
5,2000,7997,1233,9230,MQ
6,2000,7817,1172,8989,MQ
7,2000,7850,1192,9042,MQ
8,2000,7913,1166,9079,MQ
9,2000,8009,1193,9202,MQ
10,2000,8066,1221,9287,MQ
11,2000,8104,1184,9288,MQ
12,2000,8189,1235,9424,MQ
1,2001,8166,1251,9417,MQ
2,2001,8273,1227,9500,MQ
3,2001,8360,1248,9608,MQ
4,2001,8373,1226,9599,MQ
5,2001,8479,1252,9731,MQ
6,2001,8515,1280,9795,MQ
7,2001,8549,1290,9839,MQ
8,2001,8599,1280,9879,MQ
9,2001,8589,1266,9855,MQ
10,2001,8042,1165,9207,MQ
11,2001,7821,1165,8986,MQ
12,2001,7859,1179,9038,MQ
1,2002,7874,1179,9053,MQ
2,2002,7918,1183,9101,MQ
3,2002,7908,1177,9085,MQ
4,2002,7794,1183,8977,MQ
5,2002,7820,1199,9019,MQ
6,2002,7905,1207,9112,MQ
7,2002,7923,1241,9164,MQ
8,2002,7983,1244,9227,MQ
9,2002,7992,1248,9240,MQ
10,2002,7352,1004,8356,MQ
11,2002,7384,1035,8419,MQ
12,2002,7349,1016,8365,MQ
1,2003,7284,1007,8291,MQ
2,2003,7270,1022,8292,MQ
3,2003,7212,992,8204,MQ
4,2003,7205,988,8193,MQ
5,2003,7095,944,8039,MQ
6,2003,7095,944,8039,MQ
7,2003,6139,944,7083,MQ
8,2003,6998,952,7950,MQ
9,2003,7003,950,7953,MQ
10,2003,7119,985,8104,MQ
11,2003,7198,994,8192,MQ
12,2003,7225,990,8215,MQ
1,2004,7301,985,8286,MQ
2,2004,7421,1018,8439,MQ
3,2004,7622,1033,8655,MQ
4,2004,7720,1055,8775,MQ
5,2004,7890,1024,8914,MQ
6,2004,7991,1018,9009,MQ
7,2004,8080,1047,9127,MQ
8,2004,8269,1047,9316,MQ
9,2004,8416,1052,9468,MQ
10,2004,8487,1084,9571,MQ
11,2004,8562,1084,9646,MQ
12,2004,8570,1120,9690,MQ
1,2005,8666,1202,9868,MQ
2,2005,8761,1224,9985,MQ
3,2005,8809,1205,10014,MQ
4,2005,8895,1153,10048,MQ
5,2005,8895,1160,10055,MQ
6,2005,8870,1146,10016,MQ
7,2005,8801,1143,9944,MQ
8,2005,8829,1158,9987,MQ
9,2005,8874,1147,10021,MQ
10,2005,8917,1181,10098,MQ
11,2005,8881,1180,10061,MQ
12,2005,8835,1167,10002,MQ
1,2006,8759,1213,9972,MQ
2,2006,8742,1205,9947,MQ
3,2006,8703,1214,9917,MQ
4,2006,8663,1215,9878,MQ
5,2006,8625,1202,9827,MQ
6,2006,8584,1199,9783,MQ
7,2006,8595,1232,9827,MQ
8,2006,8536,1233,9769,MQ
9,2006,8586,1282,9868,MQ
10,2006,8653,1298,9951,MQ
11,2006,8627,1326,9953,MQ
12,2006,8614,1309,9923,MQ
1,2007,8655,1329,9984,MQ
2,2007,8658,1369,10027,MQ
3,2007,8750,1415,10165,MQ
4,2007,8767,1394,10161,MQ
5,2007,8713,1429,10142,MQ
6,2007,8726,1453,10179,MQ
7,2007,8770,1457,10227,MQ
8,2007,8754,1497,10251,MQ
9,2007,8800,1523,10323,MQ
10,2007,8935,1548,10483,MQ
11,2007,8895,1583,10478,MQ
12,2007,8923,1512,10435,MQ
1,2008,8921,1489,10410,MQ
2,2008,8944,1520,10464,MQ
3,2008,8954,1524,10478,MQ
4,2008,8953,1512,10465,MQ
5,2008,8970,1526,10496,MQ
6,2008,8931,1504,10435,MQ
7,2008,8882,1468,10350,MQ
8,2008,8828,1465,10293,MQ
9,2008,8723,1458,10181,MQ
10,2008,8685,1478,10163,MQ
11,2008,8534,1509,10043,MQ
12,2008,8464,1512,9976,MQ
1,2009,8478,1514,9992,MQ
2,2009,8443,1541,9984,MQ
3,2009,8426,1539,9965,MQ
4,2009,8402,1544,9946,MQ
5,2009,8362,1615,9977,MQ
6,2009,8270,1599,9869,MQ
7,2009,8221,1601,9822,MQ
8,2009,8192,1610,9802,MQ
9,2009,8189,1619,9808,MQ
10,2009,8213,1622,9835,MQ
11,2009,8213,1657,9870,MQ
12,2009,8174,1644,9818,MQ
1,2010,8207,1674,9881,MQ
2,2010,8177,1734,9911,MQ
3,2010,8172,1745,9917,MQ
4,2010,8237,1742,9979,MQ
5,2010,8375,1729,10104,MQ
6,2010,8381,1770,10151,MQ
7,2010,8395,1782,10177,MQ
8,2010,8388,1762,10150,MQ
9,2010,8479,1746,10225,MQ
10,2010,8579,1755,10334,MQ
11,2010,8568,1775,10343,MQ
12,2010,8597,1780,10377,MQ
1,2011,8628,1789,10417,MQ
2,2011,8643,1810,10453,MQ
3,2011,8733,1860,10593,MQ
4,2011,8738,1903,10641,MQ
5,2011,8753,1888,10641,MQ
6,2011,8841,1890,10731,MQ
7,2011,8903,1929,10832,MQ
8,2011,8961,1919,10880,MQ
9,2011,9084,1943,11027,MQ
10,2011,9199,1970,11169,MQ
11,2011,9182,1959,11141,MQ
12,2011,9124,1934,11058,MQ
1,2012,9114,1902,11016,MQ
2,2012,9009,1878,10887,MQ
3,2012,8974,1863,10837,MQ
4,2012,8845,1854,10699,MQ
5,2012,8864,1901,10765,MQ
6,2012,8869,1940,10809,MQ
7,2012,8847,2082,10929,MQ
8,2012,8850,2205,11055,MQ
9,2012,8920,2323,11243,MQ
10,2012,9144,2593,11737,MQ
11,2012,9294,2643,11937,MQ
12,2012,9380,2747,12127,MQ
1,2013,9859,2929,12788,MQ
2,2013,9855,2999,12854,MQ
3,2013,9740,3008,12748,MQ
4,2013,9666,2995,12661,MQ
5,2013,9661,2893,12554,MQ
6,2013,9731,2870,12601,MQ
7,2013,9654,2940,12594,MQ
8,2013,9605,3065,12670,MQ
9,2013,9571,3178,12749,MQ
10,2013,9498,3291,12789,MQ
11,2013,9473,3251,12724,MQ
12,2013,9422,3216,12638,MQ
1,2014,9383,3267,12650,MQ
2,2014,9292,3326,12618,MQ
3,2014,9219,3291,12510,MQ
4,2014,9175,3374,12549,MQ
5,2014,9130,3366,12496,MQ
6,2014,9031,3354,12385,MQ
7,2014,9092,3808,12900,MQ
8,2014,9017,3588,12605,MQ
9,2014,9086,3771,12857,MQ
10,2014,9130,3810,12940,MQ
11,2014,9612,4097,13709,MQ
12,2014,8936,3809,12745,MQ
1,2015,8799,3788,12587,MQ
2,2015,9062,3747,12809,MQ
3,2015,9139,3760,12899,MQ
4,2015,9034,3806,12840,MQ
5,2015,8975,3800,12775,MQ
6,2015,8923,3699,12622,MQ
7,2015,7890,3604,11494,MQ
8,2015,7863,3563,11426,MQ
9,2015,7941,3546,11487,MQ
10,2015,8929,3417,12346,MQ
11,2015,9012,3359,12371,MQ
12,2015,9051,3297,12348,MQ
1,2016,9023,3267,12290,MQ
2,2016,9025,3190,12215,MQ
3,2016,9077,3162,12239,MQ
4,2016,9129,3071,12200,MQ
5,2016,9141,3028,12169,MQ
6,2016,9159,3046,12205,MQ
7,2016,9239,3117,12356,MQ
8,2016,9326,3136,12462,MQ
9,2016,9356,3065,12421,MQ
10,2016,9347,3067,12414,MQ
11,2016,9374,3026,12400,MQ
12,2016,9387,3085,12472,MQ
1,2017,9500,3117,12617,MQ
2,2017,9583,3175,12758,MQ
3,2017,9636,3204,12840,MQ
4,2017,9744,3233,12977,MQ
5,2017,9821,3335,13156,MQ
6,2017,9926,3497,13423,MQ
7,2017,10019,3480,13499,MQ
8,2017,10096,3484,13580,MQ
9,2017,10248,3554,13802,MQ
10,2017,10357,3616,13973,MQ
11,2017,10471,3690,14161,MQ
12,2017,10536,3716,14252,MQ
1,2018,10690,3669,14359,MQ
2,2018,10743,3692,14435,MQ
3,2018,10812,3687,14499,MQ
4,2018,10961,3719,14680,MQ
5,2018,11028,3688,14716,MQ
6,2018,11122,3715,14837,MQ
7,2018,11086,3777,14863,MQ
8,2018,11100,3815,14915,MQ
9,2018,11208,3829,15037,MQ
10,2018,11541,3846,15387,MQ
11,2018,11647,3948,15595,MQ
12,2018,11606,3956,15562,MQ
1,2019,11798,3975,15773,MQ
2,2019,11810,4016,15826,MQ
3,2019,11834,4053,15887,MQ
4,2019,11875,4065,15940,MQ
5,2019,12011,4169,16180,MQ
6,2019,12120,4296,16416,MQ
7,2019,12104,4262,16366,MQ
8,2019,12135,4255,16390,MQ
9,2019,12237,4377,16614,MQ
10,2019,12390,4373,16763,MQ
11,2019,12471,4375,16846,MQ
12,2019,12449,4486,16935,MQ
1,2020,12494,4534,17028,MQ
2,2020,12550,4636,17186,MQ
3,2020,12389,4392,16781,MQ
4,2020,12383,4384,16767,MQ
5,2020,12409,4362,16771,MQ
6,2020,12344,4315,16659,MQ
7,2020,12193,4195,16388,MQ
8,2020,12031,4070,16101,MQ
9,2020,11966,3992,15958,MQ
10,2020,11197,3731,14928,MQ
11,2020,11098,3535,14633,MQ
12,2020,11599,3781,15380,MQ
1,2021,11521,3882,15403,MQ
2,2021,11525,3893,15418,MQ
3,2021,11439,3907,15346,MQ
4,2021,11385,4062,15447,MQ
5,2021,11200,4247,15447,MQ
6,2021,10929,4363,15292,MQ
7,2021,10822,4289,15111,MQ
8,2021,10850,4220,15070,MQ
9,2021,10915,4288,15203,MQ
10,2021,10907,4258,15165,MQ
11,2021,10932,4248,15180,MQ
12,2021,11005,4300,15305,MQ
1,2022,10996,4389,15385,MQ
2,2022,11030,4437,15467,MQ
3,2022,11161,4582,15743,MQ
4,2022,11204,4591,15795,MQ
5,2022,11262,4650,15912,MQ
6,2022,11291,4803,16094,MQ
7,2022,11347,4799,16146,MQ
8,2022,11577,4929,16506,MQ
9,2022,11609,4949,16558,MQ
10,2022,11628,5042,16670,MQ
11,2022,11628,5177,16805,MQ
12,2022,11740,5208,16948,MQ
1,2023,11682,5238,16920,MQ
2,2023,11738,5289,17027,MQ
3,2023,11884,5373,17257,MQ
4,2023,11949,5407,17356,MQ
5,2023,12074,5498,17572,MQ
6,2023,12151,5556,17707,MQ
7,2023,12219,5634,17853,MQ
8,2023,12241,5622,17863,MQ
9,2023,12243,5705,17948,MQ
10,2023,12284,5646,17930,MQ
11,2023,12357,5687,18044,MQ
12,2023,12378,5709,18087,MQ
1,2024,12468,5709,18177,MQ
2,2024,12516,5863,18379,MQ
3,2024,12595,5872,18467,MQ
4,2024,12632,5869,18501,MQ
5,2024,12643,5899,18542,MQ
6,2024,12686,5936,18622,MQ
7,2024,12558,6031,18589,MQ
8,2024,12461,6112,18573,MQ
9,2024,12433,6206,18639,MQ
10,2024,12429,6289,18718,MQ
11,2024,12411,6337,18748,MQ
12,2024,12422,6350,18772,MQ
1,2025,12435,6435,18870,MQ
8,1992,105,21,126,NK
9,1992,102,21,123,NK
10,1992,105,21,126,NK
11,1992,106,19,125,NK
12,1992,106,19,125,NK
1,1993,102,18,120,NK
2,1993,102,18,120,NK
3,1993,102,18,120,NK
4,1993,102,18,120,NK
5,1993,155,26,181,NK
6,1993,155,26,181,NK
7,1993,169,26,195,NK
8,1993,114,48,162,NK
9,1993,114,48,162,NK
10,1993,114,48,162,NK
11,1993,114,48,162,NK
12,1993,148,48,196,NK
1,1994,148,48,196,NK
2,1994,148,48,196,NK
3,1994,190,25,215,NK
4,1994,190,25,215,NK
5,1994,190,25,215,NK
6,1994,190,25,215,NK
7,1994,215,25,240,NK
8,1994,215,25,240,NK
9,1994,275,25,300,NK
10,1994,275,25,300,NK
12,1994,280,43,323,NK
1,1995,280,43,323,NK
2,1995,280,43,323,NK
3,1995,309,55,364,NK
4,1995,315,58,373,NK
5,1995,335,55,390,NK
6,1995,355,30,385,NK
7,1995,355,30,385,NK
8,1995,355,30,385,NK
9,1995,370,85,455,NK
10,1995,370,85,455,NK
11,1995,370,85,455,NK
12,1995,370,85,455,NK
1,1996,393,40,433,NK
2,1996,393,40,433,NK
3,1996,393,40,433,NK
4,1996,393,40,433,NK
5,1996,350,168,518,NK
6,1996,420,98,518,NK
7,1996,420,98,518,NK
8,1996,420,98,518,NK
9,1996,424,112,536,NK
10,1996,424,112,536,NK
11,1996,424,112,536,NK
12,1996,420,100,520,NK
1,1997,420,100,520,NK
2,1997,400,140,540,NK
3,1997,400,140,540,NK
4,1997,420,100,520,NK
5,1997,443,189,632,NK
6,1997,508,190,698,NK
7,1997,583,146,729,NK
8,1997,584,146,730,NK
9,1997,602,150,752,NK
10,1997,606,151,757,NK
11,1997,644,162,806,NK
12,1997,636,159,795,NK
1,1998,639,159,798,NK
2,1998,684,171,855,NK
3,1998,717,179,896,NK
4,1998,725,181,906,NK
5,1998,662,254,916,NK
6,1998,700,234,934,NK
7,1998,723,267,990,NK
8,1998,767,259,1026,NK
9,1998,811,254,1065,NK
10,1998,822,274,1096,NK
11,1998,878,283,1161,NK
12,1998,925,271,1196,NK
1,1999,869,279,1148,NK
2,1999,952,329,1281,NK
3,1999,1023,340,1363,NK
4,1999,1105,379,1484,NK
5,1999,1073,345,1418,NK
6,1999,1135,383,1518,NK
7,1999,1279,360,1639,NK
8,1999,1322,363,1685,NK
9,1999,1301,333,1634,NK
10,1999,1381,346,1727,NK
11,1999,1618,286,1904,NK
12,1999,1657,316,1973,NK
1,2000,1655,389,2044,NK
2,2000,1704,362,2066,NK
3,2000,1687,396,2083,NK
4,2000,1633,404,2037,NK
5,2000,1608,390,1998,NK
6,2000,1565,335,1900,NK
7,2000,1482,323,1805,NK
8,2000,1416,327,1743,NK
9,2000,1404,294,1698,NK
10,2000,1316,413,1729,NK
11,2000,1444,324,1768,NK
12,2000,1574,337,1911,NK
1,2001,1582,342,1924,NK
2,2001,1698,365,2063,NK
3,2001,1773,361,2134,NK
4,2001,1999,322,2321,NK
5,2001,2041,358,2399,NK
6,2001,1945,341,2286,NK
7,2001,1935,331,2266,NK
8,2001,1958,345,2303,NK
9,2001,2015,348,2363,NK
10,2001,1593,213,1806,NK
11,2001,1740,258,1998,NK
12,2001,1774,275,2049,NK
1,2002,1849,280,2129,NK
2,2002,1849,280,2129,NK
3,2002,1940,273,2213,NK
4,2002,2025,246,2271,NK
5,2002,2047,335,2382,NK
6,2002,2102,341,2443,NK
7,2002,2103,334,2437,NK
8,2002,2139,348,2487,NK
9,2002,2134,331,2465,NK
10,2002,2204,334,2538,NK
11,2002,2228,369,2597,NK
12,2002,2199,380,2579,NK
1,2003,2223,350,2573,NK
2,2003,2219,352,2571,NK
3,2003,2235,396,2631,NK
4,2003,2327,356,2683,NK
5,2003,2263,310,2573,NK
6,2003,2270,335,2605,NK
7,2003,2144,341,2485,NK
8,2003,2295,330,2625,NK
9,2003,2137,324,2461,NK
10,2003,2114,311,2425,NK
11,2003,2243,304,2547,NK
12,2003,2402,332,2734,NK
1,2004,2242,325,2567,NK
2,2004,2243,294,2537,NK
3,2004,2250,299,2549,NK
4,2004,2261,307,2568,NK
5,2004,2288,303,2591,NK
6,2004,2278,315,2593,NK
7,2004,2272,308,2580,NK
8,2004,2271,307,2578,NK
9,2004,2173,314,2487,NK
10,2004,2155,281,2436,NK
11,2004,2360,269,2629,NK
12,2004,2339,288,2627,NK
1,2005,2324,301,2625,NK
2,2005,2208,292,2500,NK
3,2005,2146,275,2421,NK
4,2005,2072,244,2316,NK
5,2005,1934,228,2162,NK
6,2005,1980,237,2217,NK
7,2005,2029,248,2277,NK
8,2005,1976,236,2212,NK
9,2005,1905,235,2140,NK
10,2005,1928,262,2190,NK
11,2005,1951,265,2216,NK
12,2005,1923,272,2195,NK
1,2006,1959,191,2150,NK
2,2006,1957,206,2163,NK
3,2006,1872,271,2143,NK
4,2006,1870,261,2131,NK
5,2006,1837,282,2119,NK
6,2006,1899,280,2179,NK
7,2006,1893,280,2173,NK
8,2006,1848,263,2111,NK
9,2006,1863,251,2114,NK
10,2006,1890,267,2157,NK
11,2006,1906,246,2152,NK
12,2006,1916,250,2166,NK
1,2007,1935,260,2195,NK
2,2007,1994,286,2280,NK
3,2007,1981,260,2241,NK
4,2007,2001,259,2260,NK
5,2007,2032,238,2270,NK
6,2007,2062,257,2319,NK
7,2007,2047,296,2343,NK
8,2007,2047,269,2316,NK
9,2007,2039,208,2247,NK
10,2007,2105,212,2317,NK
11,2007,2211,218,2429,NK
12,2007,2092,217,2309,NK
1,2008,2108,231,2339,NK
2,2008,2240,260,2500,NK
3,2008,2365,241,2606,NK
4,2008,2336,225,2561,NK
5,2008,2356,289,2645,NK
6,2008,2305,295,2600,NK
7,2008,2177,292,2469,NK
8,2008,2094,286,2380,NK
9,2008,2192,286,2478,NK
10,2008,2184,264,2448,NK
11,2008,2127,277,2404,NK
12,2008,2116,294,2410,NK
1,2009,1817,290,2107,NK
2,2009,1754,270,2024,NK
3,2009,1758,296,2054,NK
4,2009,1753,291,2044,NK
5,2009,1770,322,2092,NK
6,2009,1754,302,2056,NK
7,2009,1741,313,2054,NK
8,2009,1740,297,2037,NK
9,2009,1723,292,2015,NK
10,2009,1738,290,2028,NK
11,2009,1736,340,2076,NK
12,2009,1751,338,2089,NK
1,2010,1797,336,2133,NK
2,2010,1783,336,2119,NK
3,2010,1842,364,2206,NK
4,2010,1783,336,2119,NK
5,2010,1871,379,2250,NK
6,2010,1881,343,2224,NK
7,2010,1883,339,2222,NK
8,2010,1884,339,2223,NK
9,2010,2013,348,2361,NK
10,2010,1954,333,2287,NK
11,2010,1955,376,2331,NK
12,2010,2001,393,2394,NK
1,2011,2045,396,2441,NK
2,2011,2045,396,2441,NK
3,2011,1975,328,2303,NK
4,2011,2080,401,2481,NK
5,2011,2093,411,2504,NK
6,2011,2129,410,2539,NK
7,2011,2122,421,2543,NK
8,2011,2126,421,2547,NK
9,2011,2173,396,2569,NK
10,2011,2208,385,2593,NK
11,2011,2222,419,2641,NK
12,2011,2398,669,3067,NK
1,2012,2316,439,2755,NK
2,2012,2409,441,2850,NK
3,2012,2507,526,3033,NK
4,2012,2458,468,2926,NK
5,2012,2497,455,2952,NK
6,2012,2539,462,3001,NK
7,2012,2548,531,3079,NK
8,2012,3137,474,3611,NK
9,2012,2566,487,3053,NK
10,2012,2579,466,3045,NK
11,2012,2660,456,3116,NK
12,2012,3008,717,3725,NK
1,2013,2767,450,3217,NK
2,2013,2798,456,3254,NK
3,2013,2962,506,3468,NK
4,2013,2932,454,3386,NK
5,2013,3027,457,3484,NK
6,2013,3162,476,3638,NK
7,2013,3107,459,3566,NK
8,2013,3137,474,3611,NK
9,2013,3165,447,3612,NK
10,2013,3262,450,3712,NK
11,2013,3293,455,3748,NK
12,2013,3320,445,3765,NK
1,2014,3374,460,3834,NK
2,2014,3312,444,3756,NK
3,2014,3339,459,3798,NK
4,2014,3415,473,3888,NK
5,2014,3437,461,3898,NK
6,2014,3484,459,3943,NK
7,2014,3507,471,3978,NK
8,2014,3538,471,4009,NK
9,2014,3573,460,4033,NK
10,2014,3612,494,4106,NK
11,2014,4195,503,4698,NK
12,2014,3685,479,4164,NK
1,2015,3766,534,4300,NK
2,2015,3825,507,4332,NK
3,2015,3899,520,4419,NK
4,2015,3982,463,4445,NK
5,2015,4028,398,4426,NK
6,2015,4115,377,4492,NK
7,2015,4166,289,4455,NK
8,2015,4270,279,4549,NK
9,2015,4312,276,4588,NK
10,2015,4394,271,4665,NK
11,2015,4490,265,4755,NK
12,2015,4567,269,4836,NK
1,2016,4673,270,4943,NK
2,2016,4781,269,5050,NK
3,2016,4796,294,5090,NK
4,2016,4905,288,5193,NK
5,2016,5122,309,5431,NK
6,2016,5111,292,5403,NK
7,2016,5152,286,5438,NK
8,2016,5192,286,5478,NK
9,2016,5261,271,5532,NK
10,2016,5274,267,5541,NK
11,2016,5330,308,5638,NK
12,2016,5437,319,5756,NK
1,2017,5484,315,5799,NK
2,2017,5496,312,5808,NK
3,2017,5598,367,5965,NK
4,2017,5661,376,6037,NK
5,2017,5772,362,6134,NK
6,2017,5944,373,6317,NK
7,2017,6031,371,6402,NK
8,2017,6025,368,6393,NK
9,2017,6144,357,6501,NK
10,2017,6203,389,6592,NK
11,2017,6317,376,6693,NK
12,2017,6406,388,6794,NK
1,2018,6483,388,6871,NK
2,2018,6571,391,6962,NK
3,2018,6699,405,7104,NK
4,2018,6874,387,7261,NK
5,2018,6971,333,7304,NK
6,2018,7043,332,7375,NK
7,2018,7026,334,7360,NK
8,2018,7127,343,7470,NK
9,2018,7242,280,7522,NK
10,2018,7401,296,7697,NK
11,2018,7318,299,7617,NK
12,2018,7343,305,7648,NK
1,2019,7406,294,7700,NK
2,2019,7489,296,7785,NK
3,2019,7570,305,7875,NK
4,2019,7600,328,7928,NK
5,2019,7741,340,8081,NK
6,2019,7884,348,8232,NK
7,2019,7870,338,8208,NK
8,2019,7917,363,8280,NK
9,2019,8000,342,8342,NK
10,2019,8103,342,8445,NK
11,2019,8273,395,8668,NK
12,2019,8607,386,8993,NK
1,2020,8467,372,8839,NK
2,2020,8600,375,8975,NK
3,2020,8858,355,9213,NK
4,2020,8864,340,9204,NK
5,2020,8868,331,9199,NK
6,2020,8807,327,9134,NK
7,2020,8817,327,9144,NK
8,2020,8636,290,8926,NK
9,2020,8617,276,8893,NK
10,2020,8606,323,8929,NK
11,2020,8612,299,8911,NK
12,2020,8851,324,9175,NK
1,2021,8497,330,8827,NK
2,2021,8448,317,8765,NK
3,2021,8496,324,8820,NK
4,2021,8539,333,8872,NK
5,2021,8741,304,9045,NK
6,2021,8949,311,9260,NK
7,2021,9031,285,9316,NK
8,2021,9165,294,9459,NK
9,2021,9310,284,9594,NK
10,2021,9563,268,9831,NK
11,2021,9663,249,9912,NK
12,2021,10148,285,10433,NK
1,2022,9918,307,10225,NK
2,2022,9970,326,10296,NK
3,2022,10144,342,10486,NK
4,2022,10321,337,10658,NK
5,2022,10454,333,10787,NK
6,2022,10588,333,10921,NK
7,2022,10713,307,11020,NK
8,2022,10974,302,11276,NK
9,2022,11185,332,11517,NK
10,2022,11397,310,11707,NK
11,2022,11377,318,11695,NK
12,2022,11654,297,11951,NK
1,2023,11865,311,12176,NK
2,2023,11988,310,12298,NK
3,2023,12211,344,12555,NK
4,2023,12273,325,12598,NK
5,2023,12376,320,12696,NK
6,2023,12507,322,12829,NK
7,2023,12622,333,12955,NK
8,2023,12808,313,13121,NK
9,2023,12811,360,13171,NK
10,2023,12809,325,13134,NK
11,2023,12819,343,13162,NK
12,2023,13484,345,13829,NK
1,2024,12829,374,13203,NK
2,2024,12503,355,12858,NK
3,2024,12322,438,12760,NK
4,2024,12069,387,12456,NK
5,2024,12028,401,12429,NK
6,2024,11880,389,12269,NK
7,2024,11739,400,12139,NK
8,2024,11825,435,12260,NK
9,2024,11772,411,12183,NK
10,2024,11357,403,11760,NK
11,2024,11262,393,11655,NK
12,2024,11787,404,12191,NK
1,2025,11056,415,11471,NK
7,2004,1630,426,2056,OH
8,2004,1691,407,2098,OH
9,2004,1606,381,1987,OH
10,2004,1606,373,1979,OH
11,2004,1556,317,1873,OH
12,2004,1542,300,1842,OH
1,2005,1580,300,1880,OH
2,2005,1606,304,1910,OH
3,2005,1579,312,1891,OH
4,2005,1575,299,1874,OH
5,2005,1564,296,1860,OH
6,2005,1588,307,1895,OH
7,2005,1563,290,1853,OH
8,2005,1558,281,1839,OH
9,2005,1524,272,1796,OH
10,2005,1516,269,1785,OH
11,2005,1479,258,1737,OH
12,2005,1442,256,1698,OH
1,2006,1490,253,1743,OH
2,2006,1478,234,1712,OH
3,2006,1418,222,1640,OH
4,2006,1393,220,1613,OH
5,2006,1379,209,1588,OH
6,2006,1384,173,1557,OH
7,2006,1378,170,1548,OH
8,2006,1371,164,1535,OH
9,2006,1391,163,1554,OH
10,2006,1406,159,1565,OH
11,2006,1401,150,1551,OH
12,2006,1359,146,1505,OH
1,2007,1360,152,1512,OH
2,2007,1356,171,1527,OH
3,2007,1336,178,1514,OH
4,2007,1334,175,1509,OH
5,2007,1344,167,1511,OH
6,2007,1362,164,1526,OH
7,2007,1375,168,1543,OH
8,2007,1386,166,1552,OH
9,2007,1373,172,1545,OH
10,2007,1417,161,1578,OH
11,2007,1333,109,1442,OH
12,2007,1309,103,1412,OH
1,2008,1196,5,1201,OH
2,2008,1171,4,1175,OH
3,2008,1157,4,1161,OH
4,2008,1151,4,1155,OH
5,2008,1137,4,1141,OH
6,2008,1094,4,1098,OH
7,2008,1060,4,1064,OH
8,2008,1037,3,1040,OH
9,2008,988,5,993,OH
10,2008,981,5,986,OH
11,2008,992,5,997,OH
12,2008,985,5,990,OH
1,2009,959,5,964,OH
2,2009,977,5,982,OH
3,2009,975,5,980,OH
4,2009,977,4,981,OH
5,2009,989,4,993,OH
6,2009,984,4,988,OH
7,2009,982,4,986,OH
8,2009,990,4,994,OH
9,2009,995,3,998,OH
10,2009,969,2,971,OH
11,2009,965,3,968,OH
12,2009,963,3,966,OH
1,2010,957,3,960,OH
2,2010,952,3,955,OH
3,2010,965,0,965,OH
4,2010,969,3,972,OH
5,2010,989,2,991,OH
6,2010,988,2,990,OH
7,2010,1011,2,1013,OH
8,2010,1008,3,1011,OH
9,2010,997,3,1000,OH
10,2010,996,3,999,OH
11,2010,996,3,999,OH
12,2010,993,3,996,OH
1,2011,991,2,993,OH
2,2011,988,2,990,OH
3,2011,996,2,998,OH
4,2011,990,1,991,OH
5,2011,1008,1,1009,OH
6,2011,1009,1,1010,OH
7,2011,1011,1,1012,OH
8,2011,1025,1,1026,OH
9,2011,1048,2,1050,OH
10,2011,1039,2,1041,OH
11,2011,1038,2,1040,OH
12,2011,1040,1,1041,OH
1,2012,1058,1,1059,OH
2,2012,1055,2,1057,OH
3,2012,1057,2,1059,OH
4,2012,1050,2,1052,OH
5,2012,1071,2,1073,OH
6,2012,1086,2,1088,OH
7,2012,1083,2,1085,OH
8,2012,1070,2,1072,OH
9,2012,1072,2,1074,OH
10,2012,1088,2,1090,OH
11,2012,1089,1,1090,OH
12,2012,1087,1,1088,OH
1,2013,1077,2,1079,OH
2,2013,1079,2,1081,OH
3,2013,1066,2,1068,OH
4,2013,1062,2,1064,OH
5,2013,1069,2,1071,OH
6,2013,1071,2,1073,OH
7,2013,1061,2,1063,OH
8,2013,1065,2,1067,OH
9,2013,1074,1,1075,OH
10,2013,1096,1,1097,OH
11,2013,1101,1,1102,OH
12,2013,1119,1,1120,OH
1,2014,1165,1,1166,OH
2,2014,1225,3,1228,OH
3,2014,1309,3,1312,OH
4,2014,1336,3,1339,OH
5,2014,1387,3,1390,OH
6,2014,1422,3,1425,OH
7,2014,1501,0,1501,OH
8,2014,1538,4,1542,OH
9,2014,1572,4,1576,OH
10,2014,1634,3,1637,OH
11,2014,1717,3,1720,OH
12,2014,1797,4,1801,OH
1,2015,1797,4,1801,OH
2,2015,1953,5,1958,OH
3,2015,2066,4,2070,OH
4,2015,2139,4,2143,OH
5,2015,2174,5,2179,OH
6,2015,2204,12,2216,OH
7,2015,2279,4,2283,OH
8,2015,2294,4,2298,OH
9,2015,2293,4,2297,OH
10,2015,2354,3,2357,OH
11,2015,2392,4,2396,OH
12,2015,2451,5,2456,OH
1,2016,2494,3,2497,OH
2,2016,2527,4,2531,OH
3,2016,2548,4,2552,OH
4,2016,2571,4,2575,OH
5,2016,2583,4,2587,OH
6,2016,2595,4,2599,OH
7,2016,2618,4,2622,OH
8,2016,2629,4,2633,OH
9,2016,2657,5,2662,OH
10,2016,2706,5,2711,OH
11,2016,2733,5,2738,OH
12,2016,2769,5,2774,OH
1,2017,2812,5,2817,OH
2,2017,2850,7,2857,OH
3,2017,2866,7,2873,OH
4,2017,2900,8,2908,OH
5,2017,2906,8,2914,OH
6,2017,2958,8,2966,OH
7,2017,3053,8,3061,OH
8,2017,3104,8,3112,OH
9,2017,3138,6,3144,OH
10,2017,3215,7,3222,OH
11,2017,3310,8,3318,OH
12,2017,3391,7,3398,OH
1,2018,3515,7,3522,OH
2,2018,3559,7,3566,OH
3,2018,3612,6,3618,OH
4,2018,3673,4,3677,OH
5,2018,3677,6,3683,OH
6,2018,3744,7,3751,OH
7,2018,3844,6,3850,OH
8,2018,3893,7,3900,OH
9,2018,4007,7,4014,OH
10,2018,4066,9,4075,OH
11,2018,4114,8,4122,OH
12,2018,4085,7,4092,OH
1,2019,4112,9,4121,OH
2,2019,4142,8,4150,OH
3,2019,4120,8,4128,OH
4,2019,4181,8,4189,OH
5,2019,4211,8,4219,OH
6,2019,4282,8,4290,OH
7,2019,4406,8,4414,OH
8,2019,4472,8,4480,OH
9,2019,4605,8,4613,OH
10,2019,4676,8,4684,OH
11,2019,4740,8,4748,OH
12,2019,4705,8,4713,OH
1,2020,4758,8,4766,OH
2,2020,4802,8,4810,OH
3,2020,4662,8,4670,OH
4,2020,4301,5,4306,OH
5,2020,4587,0,4587,OH
6,2020,4524,0,4524,OH
7,2020,4619,0,4619,OH
8,2020,4573,0,4573,OH
9,2020,4618,0,4618,OH
10,2020,3493,0,3493,OH
11,2020,3373,0,3373,OH
12,2020,4189,0,4189,OH
1,2021,4252,0,4252,OH
2,2021,4308,0,4308,OH
3,2021,4328,0,4328,OH
4,2021,4389,0,4389,OH
5,2021,4512,0,4512,OH
6,2021,4540,0,4540,OH
7,2021,4523,0,4523,OH
8,2021,4529,0,4529,OH
9,2021,4606,0,4606,OH
10,2021,4539,0,4539,OH
11,2021,4546,0,4546,OH
12,2021,4378,0,4378,OH
1,2022,4434,0,4434,OH
2,2022,4443,0,4443,OH
3,2022,4323,0,4323,OH
4,2022,4256,0,4256,OH
5,2022,4259,0,4259,OH
6,2022,4476,0,4476,OH
7,2022,4267,0,4267,OH
8,2022,4250,0,4250,OH
9,2022,4250,0,4250,OH
10,2022,4262,0,4262,OH
11,2022,4241,0,4241,OH
12,2022,4204,0,4204,OH
1,2023,4167,0,4167,OH
2,2023,4095,0,4095,OH
3,2023,4057,0,4057,OH
4,2023,3997,0,3997,OH
5,2023,3946,0,3946,OH
6,2023,3900,0,3900,OH
7,2023,3993,0,3993,OH
8,2023,4069,0,4069,OH
9,2023,4143,0,4143,OH
10,2023,4220,0,4220,OH
11,2023,4265,0,4265,OH
12,2023,4204,0,4204,OH
1,2024,4287,0,4287,OH
2,2024,4336,0,4336,OH
3,2024,4373,0,4373,OH
4,2024,4459,0,4459,OH
5,2024,4547,0,4547,OH
6,2024,4609,0,4609,OH
7,2024,4724,0,4724,OH
8,2024,4668,0,4668,OH
9,2024,4682,0,4682,OH
10,2024,4703,0,4703,OH
11,2024,4740,0,4740,OH
12,2024,4723,0,4723,OH
1,2025,4742,0,4742,OH
1,2003,4857,779,5636,OO
2,2003,4826,796,5622,OO
3,2003,4720,814,5534,OO
4,2003,4668,810,5478,OO
5,2003,4680,785,5465,OO
6,2003,4707,754,5461,OO
7,2003,4762,754,5516,OO
8,2003,4848,762,5610,OO
9,2003,4942,801,5743,OO
10,2003,5010,789,5799,OO
11,2003,5171,832,6003,OO
12,2003,5184,875,6059,OO
1,2004,5262,908,6170,OO
2,2004,5412,965,6377,OO
3,2004,5627,985,6612,OO
4,2004,5666,930,6596,OO
5,2004,5760,940,6700,OO
6,2004,5883,940,6823,OO
7,2004,5935,927,6862,OO
8,2004,6107,962,7069,OO
9,2004,6218,996,7214,OO
10,2004,6327,1025,7352,OO
11,2004,6373,1039,7412,OO
12,2004,6462,1072,7534,OO
1,2005,6675,1084,7759,OO
2,2005,6799,1060,7859,OO
3,2005,6838,1050,7888,OO
4,2005,6939,1043,7982,OO
5,2005,7041,1082,8123,OO
6,2005,7220,1089,8309,OO
7,2005,7254,1080,8334,OO
8,2005,7324,1101,8425,OO
9,2005,7543,1177,8720,OO
10,2005,7564,1213,8777,OO
11,2005,7457,1313,8770,OO
12,2005,7440,1321,8761,OO
1,2006,7440,1326,8766,OO
2,2006,7478,1338,8816,OO
3,2006,7476,1345,8821,OO
4,2006,7506,1335,8841,OO
5,2006,7174,1262,8436,OO
6,2006,7412,1261,8673,OO
7,2006,7531,1225,8756,OO
8,2006,7680,1255,8935,OO
9,2006,7852,1277,9129,OO
10,2006,8019,1301,9320,OO
11,2006,8104,1316,9420,OO
12,2006,8126,1330,9456,OO
1,2007,8492,1366,9858,OO
2,2007,8580,1394,9974,OO
3,2007,8703,1423,10126,OO
4,2007,8776,1433,10209,OO
5,2007,9069,1434,10503,OO
6,2007,9158,1493,10651,OO
7,2007,9003,1516,10519,OO
8,2007,9026,1533,10559,OO
9,2007,9169,1594,10763,OO
10,2007,9268,1676,10944,OO
11,2007,9273,1687,10960,OO
12,2007,9381,1736,11117,OO
1,2008,9405,1710,11115,OO
2,2008,9279,1744,11023,OO
3,2008,9100,1785,10885,OO
4,2008,8830,1735,10565,OO
5,2008,8673,1722,10395,OO
6,2008,8602,1775,10377,OO
7,2008,8425,1757,10182,OO
8,2008,8328,1689,10017,OO
9,2008,8237,1678,9915,OO
10,2008,8110,1682,9792,OO
11,2008,8085,1763,9848,OO
12,2008,8083,1806,9889,OO
1,2009,8104,1818,9922,OO
2,2009,8082,1872,9954,OO
3,2009,7983,1904,9887,OO
4,2009,7902,1776,9678,OO
5,2009,7677,1798,9475,OO
6,2009,7704,1754,9458,OO
7,2009,7702,1773,9475,OO
8,2009,7697,1722,9419,OO
9,2009,7719,1736,9455,OO
10,2009,7741,1700,9441,OO
11,2009,7764,1781,9545,OO
12,2009,7790,1803,9593,OO
1,2010,7908,1875,9783,OO
2,2010,7982,1925,9907,OO
3,2010,8033,1912,9945,OO
4,2010,7855,1988,9843,OO
5,2010,7904,2078,9982,OO
6,2010,7907,2036,9943,OO
7,2010,7903,2001,9904,OO
8,2010,8106,1944,10050,OO
9,2010,8140,1926,10066,OO
10,2010,8012,2022,10034,OO
11,2010,8034,2058,10092,OO
12,2010,8034,2067,10101,OO
1,2011,7997,2104,10101,OO
2,2011,8074,2108,10182,OO
3,2011,8104,2070,10174,OO
4,2011,8194,1963,10157,OO
5,2011,8323,2033,10356,OO
6,2011,8416,2038,10454,OO
7,2011,8430,2009,10439,OO
8,2011,8430,1942,10372,OO
9,2011,8448,1847,10295,OO
10,2011,8437,1954,10391,OO
11,2011,8484,1968,10452,OO
12,2011,8426,1999,10425,OO
1,2012,8448,1995,10443,OO
2,2012,8395,1983,10378,OO
3,2012,8391,1962,10353,OO
4,2012,8302,2010,10312,OO
5,2012,8369,2028,10397,OO
6,2012,8399,2012,10411,OO
7,2012,8426,1970,10396,OO
8,2012,8725,1450,10175,OO
9,2012,8309,1713,10022,OO
10,2012,8393,1668,10061,OO
11,2012,8463,1640,10103,OO
12,2012,8513,1574,10087,OO
1,2013,8624,1551,10175,OO
2,2013,8603,1557,10160,OO
3,2013,8628,1572,10200,OO
4,2013,8759,1263,10022,OO
5,2013,8748,1398,10146,OO
6,2013,8720,1403,10123,OO
7,2013,8662,1496,10158,OO
8,2013,8713,1428,10141,OO
9,2013,8776,1351,10127,OO
10,2013,8827,1421,10248,OO
11,2013,8855,1480,10335,OO
12,2013,8900,1591,10491,OO
1,2014,8985,1661,10646,OO
2,2014,8993,1675,10668,OO
3,2014,9069,1685,10754,OO
4,2014,8969,1590,10559,OO
5,2014,8993,1683,10676,OO
6,2014,8808,1590,10398,OO
7,2014,9114,1533,10647,OO
8,2014,9103,1585,10688,OO
9,2014,9049,1561,10610,OO
10,2014,8685,1598,10283,OO
11,2014,8922,1703,10625,OO
12,2014,8870,1543,10413,OO
1,2015,8931,1537,10468,OO
2,2015,8986,1521,10507,OO
3,2015,9092,1506,10598,OO
4,2015,9212,1194,10406,OO
5,2015,9285,1297,10582,OO
6,2015,9258,1331,10589,OO
7,2015,9358,1368,10726,OO
8,2015,9389,1335,10724,OO
9,2015,9394,1310,10704,OO
10,2015,9480,1411,10891,OO
11,2015,9521,1586,11107,OO
12,2015,9585,1652,11237,OO
1,2016,9603,1669,11272,OO
2,2016,9704,1729,11433,OO
3,2016,9793,1678,11471,OO
4,2016,9757,1477,11234,OO
5,2016,9840,1580,11420,OO
6,2016,9905,1707,11612,OO
7,2016,9940,1776,11716,OO
8,2016,9959,1757,11716,OO
9,2016,9743,1675,11418,OO
10,2016,9713,1746,11459,OO
11,2016,9730,2032,11762,OO
12,2016,9839,2054,11893,OO
1,2017,9959,2052,12011,OO
2,2017,10109,2100,12209,OO
3,2017,10155,1805,11960,OO
4,2017,10175,1812,11987,OO
5,2017,10333,2060,12393,OO
6,2017,10451,2251,12702,OO
7,2017,10477,2294,12771,OO
8,2017,10625,2367,12992,OO
9,2017,10771,2398,13169,OO
10,2017,10847,2268,13115,OO
11,2017,10883,2545,13428,OO
12,2017,10984,2697,13681,OO
1,2018,11048,2731,13779,OO
2,2018,12191,2774,14965,OO
3,2018,12170,2799,14969,OO
4,2018,12074,2555,14629,OO
5,2018,12155,2676,14831,OO
6,2018,12075,2865,14940,OO
7,2018,12463,2985,15448,OO
8,2018,12596,3091,15687,OO
9,2018,12735,3136,15871,OO
10,2018,12573,3278,15851,OO
11,2018,12562,3579,16141,OO
12,2018,12737,3658,16395,OO
1,2019,11937,2248,14185,OO
2,2019,11980,2238,14218,OO
3,2019,12109,2039,14148,OO
4,2019,12142,1721,13863,OO
5,2019,12258,1997,14255,OO
6,2019,12226,1986,14212,OO
7,2019,12301,2054,14355,OO
8,2019,12458,1990,14448,OO
9,2019,12557,1874,14431,OO
10,2019,12555,1812,14367,OO
11,2019,12586,1986,14572,OO
12,2019,12700,1998,14698,OO
1,2020,12736,1910,14646,OO
2,2020,12505,1805,14310,OO
3,2020,12726,1750,14476,OO
4,2020,12588,1548,14136,OO
5,2020,12477,1485,13962,OO
6,2020,12525,1450,13975,OO
7,2020,12328,1430,13758,OO
8,2020,12234,1432,13666,OO
9,2020,12151,1421,13572,OO
10,2020,11874,1389,13263,OO
11,2020,11755,1388,13143,OO
12,2020,11813,1378,13191,OO
1,2021,12002,1418,13420,OO
2,2021,12263,1465,13728,OO
3,2021,12419,1502,13921,OO
4,2021,12385,1497,13882,OO
5,2021,13257,1680,14937,OO
6,2021,12968,1636,14604,OO
7,2021,13268,1715,14983,OO
8,2021,13536,1705,15241,OO
9,2021,13910,1693,15603,OO
10,2021,13716,1663,15379,OO
11,2021,13567,1726,15293,OO
12,2021,13558,1647,15205,OO
1,2022,13520,1646,15166,OO
2,2022,13435,1665,15100,OO
3,2022,13100,1664,14764,OO
4,2022,12836,1556,14392,OO
5,2022,12617,1678,14295,OO
6,2022,12353,1633,13986,OO
7,2022,12004,1638,13642,OO
8,2022,12047,1688,13735,OO
9,2022,12039,1743,13782,OO
10,2022,11761,1769,13530,OO
11,2022,11555,1752,13307,OO
12,2022,11852,1730,13582,OO
1,2023,11730,1668,13398,OO
2,2023,11665,1708,13373,OO
3,2023,11399,1710,13109,OO
4,2023,11392,1746,13138,OO
5,2023,11481,1786,13267,OO
6,2023,11577,1778,13355,OO
7,2023,11563,1841,13404,OO
8,2023,11599,1765,13364,OO
9,2023,11634,1671,13305,OO
10,2023,11490,1627,13117,OO
11,2023,11388,1654,13042,OO
12,2023,11470,1651,13121,OO
1,2024,11682,1644,13326,OO
2,2024,11778,1634,13412,OO
3,2024,11970,1652,13622,OO
4,2024,12048,1673,13721,OO
5,2024,12098,1709,13807,OO
6,2024,12271,1717,13988,OO
7,2024,12368,1731,14099,OO
8,2024,12548,1701,14249,OO
9,2024,12643,1731,14374,OO
10,2024,12722,1748,14470,OO
11,2024,12688,1739,14427,OO
12,2024,12876,1734,14610,OO
1,2025,12891,1776,14667,OO
1,1990,1542,163,1705,QX
2,1990,1542,163,1705,QX
3,1990,1594,173,1767,QX
4,1990,1609,166,1775,QX
5,1990,1620,169,1789,QX
6,1990,1636,166,1802,QX
7,1990,1608,180,1788,QX
8,1990,1614,184,1798,QX
9,1990,1614,184,1798,QX
10,1990,1689,220,1909,QX
11,1990,1702,182,1884,QX
12,1990,1713,169,1882,QX
1,1991,1632,189,1821,QX
2,1991,1639,191,1830,QX
3,1991,1658,216,1874,QX
4,1991,1658,216,1874,QX
5,1991,1569,210,1779,QX
6,1991,1742,209,1951,QX
7,1991,1701,204,1905,QX
8,1991,1719,213,1932,QX
9,1991,1723,221,1944,QX
10,1991,1723,221,1944,QX
11,1991,1768,219,1987,QX
12,1991,1816,217,2033,QX
1,1992,1947,217,2164,QX
2,1992,2210,0,2210,QX
3,1992,1981,0,1981,QX
4,1992,2011,0,2011,QX
5,1992,2044,0,2044,QX
6,1992,2052,0,2052,QX
7,1992,2051,0,2051,QX
8,1992,2110,0,2110,QX
9,1992,1984,222,2206,QX
10,1992,1922,227,2149,QX
11,1992,1987,228,2215,QX
12,1992,2010,226,2236,QX
1,1993,2011,232,2243,QX
2,1993,2002,233,2235,QX
3,1993,1995,238,2233,QX
4,1993,1994,236,2230,QX
5,1993,2040,241,2281,QX
6,1993,2068,254,2322,QX
7,1993,2084,259,2343,QX
8,1993,2075,262,2337,QX
9,1993,2064,273,2337,QX
10,1993,2072,283,2355,QX
11,1993,2055,301,2356,QX
12,1993,2065,302,2367,QX
1,1994,2066,304,2370,QX
2,1994,2105,304,2409,QX
3,1994,2107,317,2424,QX
4,1994,2135,322,2457,QX
5,1994,2153,322,2475,QX
6,1994,2220,302,2522,QX
7,1994,2287,311,2598,QX
8,1994,2259,348,2607,QX
9,1994,2274,341,2615,QX
10,1994,2339,360,2699,QX
11,1994,2404,371,2775,QX
12,1994,2431,369,2800,QX
1,1995,2454,378,2832,QX
2,1995,2493,375,2868,QX
3,1995,2520,380,2900,QX
4,1995,2526,384,2910,QX
5,1995,2569,411,2980,QX
6,1995,2574,411,2985,QX
7,1995,2602,414,3016,QX
8,1995,2588,403,2991,QX
9,1995,2550,393,2943,QX
10,1995,2519,395,2914,QX
11,1995,2576,410,2986,QX
12,1995,2555,397,2952,QX
1,1996,2494,412,2906,QX
2,1996,2494,403,2897,QX
3,1996,2503,411,2914,QX
4,1996,2513,424,2937,QX
5,1996,2531,412,2943,QX
6,1996,2546,421,2967,QX
7,1996,2550,422,2972,QX
8,1996,2552,435,2987,QX
9,1996,2550,423,2973,QX
10,1996,2544,440,2984,QX
11,1996,2565,446,3011,QX
12,1996,2980,32,3012,QX
1,1997,2950,32,2982,QX
2,1997,2503,423,2926,QX
3,1997,2489,423,2912,QX
4,1997,2477,431,2908,QX
5,1997,2465,418,2883,QX
6,1997,2470,421,2891,QX
7,1997,2439,433,2872,QX
8,1997,2381,414,2795,QX
9,1997,2357,412,2769,QX
10,1997,2386,429,2815,QX
11,1997,2407,444,2851,QX
12,1997,2397,438,2835,QX
1,1998,2397,442,2839,QX
2,1998,2423,457,2880,QX
3,1998,2453,454,2907,QX
4,1998,2510,453,2963,QX
5,1998,2557,443,3000,QX
6,1998,2605,437,3042,QX
7,1998,2660,453,3113,QX
8,1998,2643,456,3099,QX
9,1998,2667,433,3100,QX
10,1998,2765,452,3217,QX
11,1998,2767,457,3224,QX
12,1998,2771,469,3240,QX
1,1999,2805,478,3283,QX
2,1999,2901,487,3388,QX
3,1999,2946,506,3452,QX
4,1999,3039,509,3548,QX
5,1999,3097,516,3613,QX
6,1999,3170,535,3705,QX
7,1999,3197,544,3741,QX
8,1999,3211,556,3767,QX
9,1999,3190,571,3761,QX
10,1999,3230,573,3803,QX
11,1999,3237,564,3801,QX
12,1999,3235,563,3798,QX
1,2000,3210,561,3771,QX
2,2000,3179,567,3746,QX
3,2000,3208,568,3776,QX
4,2000,3203,559,3762,QX
5,2000,3215,561,3776,QX
6,2000,3385,574,3959,QX
7,2000,3418,589,4007,QX
8,2000,3432,573,4005,QX
9,2000,3483,578,4061,QX
10,2000,3543,570,4113,QX
11,2000,3562,588,4150,QX
12,2000,3517,625,4142,QX
1,2001,3527,639,4166,QX
2,2001,3568,636,4204,QX
3,2001,3543,630,4173,QX
4,2001,3488,636,4124,QX
5,2001,3409,640,4049,QX
6,2001,3379,622,4001,QX
7,2001,3371,621,3992,QX
8,2001,3347,630,3977,QX
9,2001,3318,636,3954,QX
10,2001,3230,674,3904,QX
11,2001,3167,656,3823,QX
12,2001,3149,644,3793,QX
1,2002,3117,621,3738,QX
2,2002,3124,589,3713,QX
3,2002,3133,583,3716,QX
4,2002,3172,589,3761,QX
5,2002,3142,587,3729,QX
6,2002,3195,601,3796,QX
7,2002,3205,582,3787,QX
8,2002,3193,595,3788,QX
9,2002,3134,604,3738,QX
10,2002,3103,591,3694,QX
11,2002,3108,579,3687,QX
12,2002,3131,556,3687,QX
1,2003,3126,547,3673,QX
2,2003,3121,538,3659,QX
3,2003,3119,536,3655,QX
4,2003,3129,542,3671,QX
5,2003,3107,526,3633,QX
6,2003,3106,501,3607,QX
7,2003,3108,498,3606,QX
8,2003,3099,498,3597,QX
9,2003,3083,492,3575,QX
10,2003,3060,489,3549,QX
11,2003,3064,489,3553,QX
12,2003,3078,465,3543,QX
1,2004,3120,448,3568,QX
2,2004,3156,440,3596,QX
3,2004,3122,442,3564,QX
4,2004,3157,478,3635,QX
5,2004,3121,479,3600,QX
6,2004,3129,495,3624,QX
7,2004,3119,481,3600,QX
8,2004,3101,485,3586,QX
9,2004,3076,483,3559,QX
10,2004,3098,494,3592,QX
11,2004,3106,481,3587,QX
12,2004,3084,476,3560,QX
1,2005,3107,463,3570,QX
2,2005,3116,450,3566,QX
3,2005,3113,455,3568,QX
4,2005,3140,460,3600,QX
5,2005,3173,465,3638,QX
6,2005,3160,470,3630,QX
7,2005,3167,483,3650,QX
8,2005,3188,477,3665,QX
9,2005,3214,471,3685,QX
10,2005,3204,487,3691,QX
11,2005,3240,497,3737,QX
12,2005,3261,486,3747,QX
1,2006,3874,491,4365,QX
2,2006,3271,474,3745,QX
3,2006,3292,488,3780,QX
4,2006,3278,496,3774,QX
5,2006,3872,508,4380,QX
6,2006,3304,500,3804,QX
7,2006,3227,499,3726,QX
8,2006,3357,489,3846,QX
9,2006,3361,515,3876,QX
10,2006,3389,524,3913,QX
11,2006,3386,519,3905,QX
12,2006,3408,496,3904,QX
1,2007,3451,525,3976,QX
2,2007,3455,512,3967,QX
3,2007,3490,500,3990,QX
4,2007,3469,551,4020,QX
5,2007,3521,551,4072,QX
6,2007,3553,557,4110,QX
7,2007,3541,572,4113,QX
8,2007,3510,604,4114,QX
9,2007,3448,630,4078,QX
10,2007,3471,636,4107,QX
11,2007,3450,620,4070,QX
12,2007,3426,630,4056,QX
1,2008,3436,629,4065,QX
2,2008,3432,620,4052,QX
3,2008,3443,618,4061,QX
4,2008,3462,629,4091,QX
5,2008,3473,623,4096,QX
6,2008,3385,656,4041,QX
7,2008,3370,610,3980,QX
8,2008,3274,624,3898,QX
9,2008,3239,613,3852,QX
10,2008,3219,606,3825,QX
11,2008,3149,614,3763,QX
12,2008,3143,608,3751,QX
1,2009,3097,601,3698,QX
2,2009,3083,624,3707,QX
3,2009,3037,638,3675,QX
4,2009,3019,621,3640,QX
5,2009,2942,645,3587,QX
6,2009,2912,641,3553,QX
7,2009,2918,623,3541,QX
8,2009,2931,582,3513,QX
9,2009,2931,593,3524,QX
10,2009,2902,625,3527,QX
11,2009,2903,613,3516,QX
12,2009,2912,596,3508,QX
1,2010,2859,598,3457,QX
2,2010,2851,596,3447,QX
3,2010,2749,557,3306,QX
4,2010,2739,598,3337,QX
5,2010,2728,596,3324,QX
6,2010,2704,586,3290,QX
7,2010,2703,568,3271,QX
8,2010,2622,508,3130,QX
9,2010,2603,473,3076,QX
10,2010,2681,513,3194,QX
11,2010,2643,553,3196,QX
12,2010,2648,524,3172,QX
1,2011,2865,450,3315,QX
2,2011,2650,470,3120,QX
3,2011,2653,444,3097,QX
4,2011,2605,461,3066,QX
5,2011,2607,455,3062,QX
6,2011,2597,446,3043,QX
7,2011,2612,432,3044,QX
8,2011,2608,448,3056,QX
9,2011,2626,460,3086,QX
10,2011,2589,497,3086,QX
11,2011,2601,487,3088,QX
12,2011,2591,477,3068,QX
1,2012,2573,480,3053,QX
2,2012,2585,477,3062,QX
3,2012,2546,491,3037,QX
4,2012,2580,474,3054,QX
5,2012,2534,462,2996,QX
6,2012,2580,467,3047,QX
7,2012,2521,519,3040,QX
8,2012,2490,516,3006,QX
9,2012,2456,542,2998,QX
10,2012,2467,530,2997,QX
11,2012,2453,500,2953,QX
12,2012,2433,521,2954,QX
1,2013,2458,496,2954,QX
2,2013,2452,469,2921,QX
3,2013,2396,508,2904,QX
4,2013,2414,515,2929,QX
5,2013,2383,520,2903,QX
6,2013,2400,480,2880,QX
7,2013,2420,479,2899,QX
8,2013,2429,473,2902,QX
9,2013,2447,484,2931,QX
10,2013,2474,489,2963,QX
11,2013,2496,456,2952,QX
12,2013,2480,501,2981,QX
1,2014,2553,484,3037,QX
2,2014,2551,493,3044,QX
3,2014,2569,481,3050,QX
4,2014,2538,499,3037,QX
5,2014,2558,520,3078,QX
6,2014,2561,508,3069,QX
7,2014,2602,488,3090,QX
8,2014,2529,529,3058,QX
9,2014,2566,525,3091,QX
10,2014,2563,541,3104,QX
11,2014,2595,520,3115,QX
12,2014,2634,521,3155,QX
1,2015,2632,497,3129,QX
2,2015,2612,524,3136,QX
3,2015,2724,470,3194,QX
4,2015,2858,499,3357,QX
5,2015,2823,536,3359,QX
6,2015,2848,549,3397,QX
7,2015,2835,554,3389,QX
8,2015,2912,542,3454,QX
9,2015,2897,563,3460,QX
10,2015,2930,609,3539,QX
11,2015,2916,630,3546,QX
12,2015,2898,631,3529,QX
1,2016,2954,646,3600,QX
2,2016,2915,661,3576,QX
3,2016,2905,667,3572,QX
4,2016,2921,665,3586,QX
5,2016,2926,656,3582,QX
6,2016,2974,657,3631,QX
7,2016,2986,645,3631,QX
8,2016,2919,660,3579,QX
9,2016,2929,687,3616,QX
10,2016,2932,703,3635,QX
11,2016,2952,678,3630,QX
12,2016,2953,683,3636,QX
1,2017,2921,732,3653,QX
2,2017,2927,720,3647,QX
3,2017,2940,732,3672,QX
4,2017,2925,750,3675,QX
5,2017,2971,759,3730,QX
6,2017,3020,746,3766,QX
7,2017,3072,740,3812,QX
8,2017,3121,723,3844,QX
9,2017,3208,732,3940,QX
10,2017,3226,765,3991,QX
11,2017,3238,738,3976,QX
12,2017,3204,748,3952,QX
1,2018,3216,750,3966,QX
2,2018,3222,742,3964,QX
3,2018,3186,793,3979,QX
4,2018,3180,786,3966,QX
5,2018,3179,772,3951,QX
6,2018,3184,772,3956,QX
7,2018,3209,774,3983,QX
8,2018,3196,776,3972,QX
9,2018,3273,734,4007,QX
10,2018,3317,725,4042,QX
11,2018,3274,755,4029,QX
12,2018,3308,743,4051,QX
1,2019,3342,754,4096,QX
2,2019,3351,732,4083,QX
3,2019,3360,749,4109,QX
4,2019,3283,765,4048,QX
5,2019,3322,762,4084,QX
6,2019,3326,772,4098,QX
7,2019,3283,800,4083,QX
8,2019,3355,797,4152,QX
9,2019,3377,833,4210,QX
10,2019,3384,839,4223,QX
11,2019,3485,833,4318,QX
12,2019,3493,808,4301,QX
1,2020,3452,868,4320,QX
2,2020,3543,844,4387,QX
3,2020,3505,833,4338,QX
4,2020,3361,943,4304,QX
5,2020,3333,931,4264,QX
6,2020,3415,792,4207,QX
7,2020,3360,763,4123,QX
8,2020,3287,765,4052,QX
9,2020,3262,713,3975,QX
10,2020,2852,670,3522,QX
11,2020,2868,657,3525,QX
12,2020,2871,640,3511,QX
1,2021,2882,625,3507,QX
2,2021,2935,611,3546,QX
3,2021,2932,618,3550,QX
4,2021,2998,589,3587,QX
5,2021,3012,616,3628,QX
6,2021,2965,630,3595,QX
7,2021,2972,641,3613,QX
8,2021,2998,627,3625,QX
9,2021,2953,646,3599,QX
10,2021,2907,646,3553,QX
11,2021,2896,365,3261,QX
12,2021,2864,630,3494,QX
1,2022,2941,621,3562,QX
2,2022,2866,633,3499,QX
3,2022,2866,626,3492,QX
4,2022,2921,620,3541,QX
5,2022,2944,600,3544,QX
6,2022,2968,604,3572,QX
7,2022,2966,601,3567,QX
8,2022,2880,608,3488,QX
9,2022,2826,638,3464,QX
10,2022,2752,650,3402,QX
11,2022,2697,650,3347,QX
12,2022,2637,644,3281,QX
1,2023,2610,640,3250,QX
2,2023,2584,631,3215,QX
3,2023,2523,629,3152,QX
4,2023,2533,636,3169,QX
5,2023,2509,650,3159,QX
6,2023,2489,690,3179,QX
7,2023,2519,717,3236,QX
8,2023,2494,711,3205,QX
9,2023,2495,750,3245,QX
10,2023,2462,763,3225,QX
11,2023,2439,772,3211,QX
12,2023,2425,783,3208,QX
1,2024,2415,787,3202,QX
2,2024,2449,772,3221,QX
3,2024,2506,825,3331,QX
4,2024,2514,825,3339,QX
5,2024,2512,826,3338,QX
6,2024,2515,829,3344,QX
7,2024,2500,832,3332,QX
8,2024,2522,852,3374,QX
9,2024,2534,865,3399,QX
10,2024,2527,880,3407,QX
11,2024,2527,880,3407,QX
12,2024,2493,907,3400,QX
1,2025,2513,916,3429,QX
1,1990,65664,5457,71121,UA
2,1990,65839,5446,71285,UA
3,1990,66070,5445,71515,UA
4,1990,66779,5518,72297,UA
5,1990,67217,5675,72892,UA
6,1990,67924,5978,73902,UA
7,1990,68331,5966,74297,UA
8,1990,68431,5992,74423,UA
9,1990,68472,5714,74186,UA
10,1990,68640,5668,74308,UA
11,1990,69091,5681,74772,UA
12,1990,69277,5748,75025,UA
1,1991,69448,5657,75105,UA
2,1991,69460,5661,75121,UA
3,1991,70730,5670,76400,UA
4,1991,71207,5685,76892,UA
5,1991,72036,5835,77871,UA
6,1991,72936,6094,79030,UA
7,1991,73259,6229,79488,UA
8,1991,73749,6266,80015,UA
9,1991,73537,6159,79696,UA
10,1991,73780,6214,79994,UA
11,1991,73987,6235,80222,UA
12,1991,74903,6339,81242,UA
1,1992,74518,6345,80863,UA
2,1992,74660,6241,80901,UA
3,1992,74850,6345,81195,UA
4,1992,74857,6364,81221,UA
5,1992,75012,6510,81522,UA
6,1992,75759,6952,82711,UA
7,1992,76161,7250,83411,UA
8,1992,76233,7230,83463,UA
9,1992,75970,7100,83070,UA
10,1992,75718,6966,82684,UA
11,1992,76335,7122,83457,UA
12,1992,76689,7224,83913,UA
1,1993,75992,7062,83054,UA
2,1993,74760,7120,81880,UA
3,1993,74602,7034,81636,UA
4,1993,74569,7020,81589,UA
5,1993,74654,7296,81950,UA
6,1993,75133,7833,82966,UA
7,1993,75474,7910,83384,UA
8,1993,75303,7882,83185,UA
9,1993,74748,7611,82359,UA
10,1993,74249,7535,81784,UA
11,1993,74138,7539,81677,UA
12,1993,73849,7662,81511,UA
1,1994,72762,7361,80123,UA
2,1994,71144,6869,78013,UA
3,1994,69599,6703,76302,UA
4,1994,69068,6787,75855,UA
5,1994,68361,6791,75152,UA
6,1994,68307,7013,75320,UA
7,1994,68172,7199,75371,UA
8,1994,67891,7265,75156,UA
9,1994,67925,7079,75004,UA
10,1994,67565,7351,74916,UA
11,1994,67775,7499,75274,UA
12,1994,68135,7933,76068,UA
1,1995,68357,7734,76091,UA
2,1995,69112,7765,76877,UA
3,1995,70053,7821,77874,UA
4,1995,70365,7937,78302,UA
5,1995,71144,8021,79165,UA
6,1995,72198,8704,80902,UA
7,1995,72536,8843,81379,UA
8,1995,72536,8906,81442,UA
9,1995,72450,8686,81136,UA
10,1995,72280,9157,81437,UA
11,1995,72660,9203,81863,UA
12,1995,72880,9280,82160,UA
1,1996,73234,9250,82484,UA
2,1996,73417,9322,82739,UA
3,1996,73896,9245,83141,UA
4,1996,74113,9234,83347,UA
5,1996,74057,9972,84029,UA
6,1996,74361,10257,84618,UA
7,1996,74375,10302,84677,UA
8,1996,74181,10348,84529,UA
9,1996,74292,10238,84530,UA
10,1996,74493,10296,84789,UA
11,1996,74922,10510,85432,UA
12,1996,75244,10764,86008,UA
1,1997,75395,10794,86189,UA
2,1997,75387,10913,86300,UA
3,1997,75655,10788,86443,UA
4,1997,75945,10779,86724,UA
5,1997,76632,11161,87793,UA
6,1997,77563,11376,88939,UA
7,1997,78583,11439,90022,UA
8,1997,79025,11347,90372,UA
9,1997,79145,11179,90324,UA
10,1997,79508,11202,90710,UA
11,1997,79847,11263,91110,UA
12,1997,80439,11282,91721,UA
1,1998,80663,11406,92069,UA
2,1998,81021,11182,92203,UA
3,1998,81460,11121,92581,UA
4,1998,81946,11178,93124,UA
5,1998,82460,11182,93642,UA
6,1998,82684,11380,94064,UA
7,1998,82750,11477,94227,UA
8,1998,82937,11142,94079,UA
9,1998,83218,11052,94270,UA
10,1998,83388,11076,94464,UA
11,1998,83886,10904,94790,UA
12,1998,84009,10894,94903,UA
1,1999,84181,10815,94996,UA
2,1999,84319,10850,95169,UA
3,1999,85113,11126,96239,UA
4,1999,85493,11121,96614,UA
5,1999,86163,11269,97432,UA
6,1999,86841,11454,98295,UA
7,1999,87523,11298,98821,UA
8,1999,87088,11671,98759,UA
9,1999,87201,11689,98890,UA
10,1999,87791,11269,99060,UA
11,1999,88720,10951,99671,UA
12,1999,88896,11020,99916,UA
1,2000,88988,10822,99810,UA
2,2000,88701,10766,99467,UA
3,2000,88663,11102,99765,UA
4,2000,88812,11101,99913,UA
5,2000,88855,11488,100343,UA
6,2000,89668,11205,100873,UA
7,2000,90033,11305,101338,UA
8,2000,90108,11307,101415,UA
9,2000,90064,11389,101453,UA
10,2000,90492,10927,101419,UA
11,2000,90838,10920,101758,UA
12,2000,90398,11416,101814,UA
1,2001,90581,11291,101872,UA
2,2001,90763,11034,101797,UA
3,2001,91041,11005,102046,UA
4,2001,91030,10795,101825,UA
5,2001,91122,10614,101736,UA
6,2001,91956,9915,101871,UA
7,2001,91715,9775,101490,UA
8,2001,91584,9677,101261,UA
9,2001,91019,9633,100652,UA
10,2001,89067,9238,98305,UA
11,2001,78476,7087,85563,UA
12,2001,77465,6648,84113,UA
1,2002,77418,6559,83977,UA
2,2002,74763,6500,81263,UA
3,2002,73934,6211,80145,UA
4,2002,75240,6388,81628,UA
5,2002,76032,6545,82577,UA
6,2002,76288,6694,82982,UA
7,2002,76262,6799,83061,UA
8,2002,76224,6931,83155,UA
9,2002,75656,6930,82586,UA
10,2002,74847,6940,81787,UA
11,2002,74406,6913,81319,UA
12,2002,73495,6917,80412,UA
1,2003,71618,6494,78112,UA
2,2003,66080,6154,72234,UA
3,2003,64125,5918,70043,UA
4,2003,64072,5856,69928,UA
5,2003,62077,5779,67856,UA
6,2003,60436,6363,66799,UA
7,2003,57693,6800,64493,UA
8,2003,56413,6854,63267,UA
9,2003,56133,6952,63085,UA
10,2003,55225,6965,62190,UA
11,2003,55225,6965,62190,UA
12,2003,55214,6964,62178,UA
1,2004,55132,6916,62048,UA
2,2004,55147,6945,62092,UA
3,2004,55144,6945,62089,UA
4,2004,55971,6806,62777,UA
5,2004,55939,6773,62712,UA
6,2004,55858,6788,62646,UA
7,2004,55828,6788,62616,UA
8,2004,55451,6707,62158,UA
9,2004,55144,6691,61835,UA
10,2004,54979,6660,61639,UA
11,2004,54902,6671,61573,UA
12,2004,54460,6632,61092,UA
1,2005,53503,6802,60305,UA
2,2005,52591,6803,59394,UA
3,2005,52489,6819,59308,UA
4,2005,52131,6796,58927,UA
5,2005,51902,6677,58579,UA
6,2005,51301,6719,58020,UA
7,2005,51187,6604,57791,UA
8,2005,50676,6493,57169,UA
9,2005,50720,6392,57112,UA
10,2005,50476,6366,56842,UA
11,2005,50647,6300,56947,UA
12,2005,50474,6243,56717,UA
1,2006,50345,6172,56517,UA
2,2006,50244,6248,56492,UA
3,2006,50343,6176,56519,UA
4,2006,50465,6299,56764,UA
5,2006,50394,6317,56711,UA
6,2006,50039,6270,56309,UA
7,2006,49904,6163,56067,UA
8,2006,50167,5922,56089,UA
9,2006,50004,5799,55803,UA
10,2006,49492,5730,55222,UA
11,2006,49587,5704,55291,UA
12,2006,49484,5711,55195,UA
1,2007,49153,5720,54873,UA
2,2007,49061,5693,54754,UA
3,2007,49088,5624,54712,UA
4,2007,49052,5579,54631,UA
5,2007,48943,5643,54586,UA
6,2007,48950,5649,54599,UA
7,2007,48925,5580,54505,UA
8,2007,49043,5605,54648,UA
9,2007,49378,5516,54894,UA
10,2007,49562,5621,55183,UA
11,2007,49600,5650,55250,UA
12,2007,49619,5631,55250,UA
1,2008,49648,5640,55288,UA
2,2008,49632,5622,55254,UA
3,2008,49954,5708,55662,UA
4,2008,49819,5708,55527,UA
5,2008,49367,5650,55017,UA
6,2008,48789,5668,54457,UA
7,2008,48141,5583,53724,UA
8,2008,46933,5732,52665,UA
9,2008,44911,5650,50561,UA
10,2008,44363,5670,50033,UA
11,2008,44000,5584,49584,UA
12,2008,43010,5561,48571,UA
1,2009,43009,5491,48500,UA
2,2009,43024,5473,48497,UA
3,2009,43011,5468,48479,UA
4,2009,43032,5446,48478,UA
5,2009,42888,5464,48352,UA
6,2009,42539,5363,47902,UA
7,2009,42660,5346,48006,UA
8,2009,42909,5374,48283,UA
9,2009,41661,5380,47041,UA
10,2009,41434,5263,46697,UA
11,2009,41276,5231,46507,UA
12,2009,41342,5196,46538,UA
1,2010,41211,5151,46362,UA
2,2010,41107,5179,46286,UA
3,2010,41160,5155,46315,UA
4,2010,41044,5271,46315,UA
5,2010,40988,5266,46254,UA
6,2010,40944,5306,46250,UA
7,2010,41007,5291,46298,UA
8,2010,40955,5280,46235,UA
9,2010,40895,5318,46213,UA
10,2010,40907,5333,46240,UA
11,2010,40955,5307,46262,UA
12,2010,40955,5307,46262,UA
1,2011,40994,5306,46300,UA
2,2011,40919,5365,46284,UA
3,2011,40928,5312,46240,UA
4,2011,40826,5309,46135,UA
5,2011,41029,5296,46325,UA
6,2011,40522,5259,45781,UA
7,2011,40598,5257,45855,UA
8,2011,40665,5139,45804,UA
9,2011,40801,5057,45858,UA
10,2011,41087,5069,46156,UA
11,2011,41242,5038,46280,UA
12,2011,41410,5080,46490,UA
1,2012,75505,11694,87199,UA
2,2012,75946,11494,87440,UA
3,2012,76442,11370,87812,UA
4,2012,76654,11292,87946,UA
5,2012,76803,11369,88172,UA
6,2012,76892,11346,88238,UA
7,2012,76992,11250,88242,UA
8,2012,76273,11345,87618,UA
9,2012,76436,11401,87837,UA
10,2012,76514,11595,88109,UA
11,2012,76578,11605,88183,UA
12,2012,76581,11604,88185,UA
1,2013,76420,11577,87997,UA
2,2013,76383,11661,88044,UA
3,2013,76530,11709,88239,UA
4,2013,76527,11838,88365,UA
5,2013,76646,11884,88530,UA
6,2013,76551,11893,88444,UA
7,2013,76511,11976,88487,UA
8,2013,76118,11928,88046,UA
9,2013,76032,12100,88132,UA
10,2013,76131,12020,88151,UA
11,2013,75981,11798,87779,UA
12,2013,75554,11628,87182,UA
1,2014,75554,11628,87182,UA
2,2014,74760,11868,86628,UA
3,2014,74779,11830,86609,UA
4,2014,74448,11898,86346,UA
5,2014,74537,11925,86462,UA
6,2014,74162,11667,85829,UA
7,2014,74018,11563,85581,UA
8,2014,73540,11445,84985,UA
9,2014,73363,11401,84764,UA
10,2014,72792,11312,84104,UA
11,2014,73284,11212,84496,UA
12,2014,73254,11161,84415,UA
1,2015,72837,11127,83964,UA
2,2015,72829,11101,83930,UA
3,2015,73133,11099,84232,UA
4,2015,73282,11026,84308,UA
5,2015,73288,10744,84032,UA
6,2015,73486,10573,84059,UA
7,2015,73512,10450,83962,UA
8,2015,73561,10469,84030,UA
9,2015,73106,10587,83693,UA
10,2015,73161,10629,83790,UA
11,2015,73468,10740,84208,UA
12,2015,73578,10559,84137,UA
1,2016,73658,10817,84475,UA
2,2016,73942,10885,84827,UA
3,2016,74637,10879,85516,UA
4,2016,74900,10907,85807,UA
5,2016,75402,10773,86175,UA
6,2016,75849,10693,86542,UA
7,2016,76213,10799,87012,UA
8,2016,76206,11002,87208,UA
9,2016,76204,11144,87348,UA
10,2016,76311,11184,87495,UA
11,2016,76478,11098,87576,UA
12,2016,76641,10981,87622,UA
1,2017,76611,11070,87681,UA
2,2017,76649,11151,87800,UA
3,2017,76911,11226,88137,UA
4,2017,77237,11233,88470,UA
5,2017,77329,11219,88548,UA
6,2017,77349,11146,88495,UA
7,2017,77420,11078,88498,UA
8,2017,77237,11128,88365,UA
9,2017,76929,11350,88279,UA
10,2017,76873,11594,88467,UA
11,2017,76851,11591,88442,UA
12,2017,76873,11501,88374,UA
1,2018,76555,11617,88172,UA
2,2018,76736,11560,88296,UA
3,2018,76755,11403,88158,UA
4,2018,77383,11296,88679,UA
5,2018,77411,11314,88725,UA
6,2018,77707,11151,88858,UA
7,2018,77554,11080,88634,UA
8,2018,77432,11006,88438,UA
9,2018,77329,11194,88523,UA
10,2018,77160,11344,88504,UA
11,2018,77202,11327,88529,UA
12,2018,77369,11168,88537,UA
1,2019,77674,11152,88826,UA
2,2019,77959,11092,89051,UA
3,2019,78247,11289,89536,UA
4,2019,78521,11575,90096,UA
5,2019,78882,11664,90546,UA
6,2019,79178,11674,90852,UA
7,2019,79133,11617,90750,UA
8,2019,79171,11533,90704,UA
9,2019,79224,11643,90867,UA
10,2019,79342,11767,91109,UA
11,2019,79301,11814,91115,UA
12,2019,79745,11701,91446,UA
1,2020,80145,11892,92037,UA
2,2020,80362,11887,92249,UA
3,2020,80239,11324,91563,UA
4,2020,78370,8999,87369,UA
5,2020,76053,7670,83723,UA
6,2020,74779,7449,82228,UA
7,2020,71580,7229,78809,UA
8,2020,70558,7343,77901,UA
9,2020,70310,6911,77221,UA
10,2020,54639,7681,62320,UA
11,2020,54411,7871,62282,UA
12,2020,54725,7860,62585,UA
1,2021,61065,8046,69111,UA
2,2021,61950,8108,70058,UA
3,2021,59166,8125,67291,UA
4,2021,59536,8395,67931,UA
5,2021,59986,8747,68733,UA
6,2021,60215,8881,69096,UA
7,2021,61319,8966,70285,UA
8,2021,62612,8926,71538,UA
9,2021,63810,8829,72639,UA
10,2021,63810,8829,72639,UA
11,2021,62427,9422,71849,UA
12,2021,65022,13318,78340,UA
1,2022,66439,12942,79381,UA
2,2022,67102,13481,80583,UA
3,2022,68150,13774,81924,UA
4,2022,69124,14203,83327,UA
5,2022,69949,14765,84714,UA
6,2022,70959,15077,86036,UA
7,2022,71659,15177,86836,UA
8,2022,72373,15524,87897,UA
9,2022,73076,15868,88944,UA
10,2022,74163,16253,90416,UA
11,2022,75054,16424,91478,UA
12,2022,75612,16233,91845,UA
1,2023,76648,16453,93101,UA
2,2023,77580,16603,94183,UA
3,2023,78778,16694,95472,UA
4,2023,79783,16760,96543,UA
5,2023,80936,16801,97737,UA
6,2023,82153,16678,98831,UA
7,2023,83198,16560,99758,UA
8,2023,84118,16518,100636,UA
9,2023,84747,16625,101372,UA
10,2023,85140,16835,101975,UA
11,2023,85569,16835,102404,UA
12,2023,85926,16649,102575,UA
1,2024,86609,16444,103053,UA
2,2024,86907,16364,103271,UA
3,2024,87257,16525,103782,UA
4,2024,87703,16702,104405,UA
5,2024,88527,16977,105504,UA
6,2024,88519,17080,105599,UA
7,2024,88605,17151,105756,UA
8,2024,88297,17119,105416,UA
9,2024,88473,17391,105864,UA
10,2024,88703,17452,106155,UA
11,2024,88846,17557,106403,UA
12,2024,89302,17487,106789,UA
1,2025,89976,17604,107580,UA
1,1990,48657,4244,52901,US
2,1990,48799,4244,53043,US
3,1990,49252,4144,53396,US
4,1990,49172,4142,53314,US
5,1990,49061,4102,53163,US
6,1990,49413,4144,53557,US
7,1990,49604,4172,53776,US
8,1990,49328,3950,53278,US
10,1990,48029,2806,50835,US
11,1990,47932,2814,50746,US
12,1990,47756,2790,50546,US
1,1991,47307,2754,50061,US
2,1991,47168,2652,49820,US
3,1991,47177,2616,49793,US
4,1991,46970,2614,49584,US
5,1991,44975,2210,47185,US
6,1991,44947,2202,47149,US
7,1991,44885,2220,47105,US
8,1991,44581,2254,46835,US
9,1991,44346,2230,46576,US
10,1991,44213,2210,46423,US
11,1991,44365,2222,46587,US
12,1991,44299,2210,46509,US
1,1992,44117,1842,45959,US
2,1992,44200,1842,46042,US
3,1992,44359,1844,46203,US
4,1992,44508,2068,46576,US
5,1992,44492,2240,46732,US
6,1992,44502,2326,46828,US
7,1992,44843,2586,47429,US
8,1992,44760,2476,47236,US
9,1992,44780,2532,47312,US
10,1992,44733,2506,47239,US
11,1992,44866,2554,47420,US
12,1992,44990,2340,47330,US
1,1993,44970,2332,47302,US
2,1993,44813,2520,47333,US
3,1993,44758,2554,47312,US
4,1993,44709,2524,47233,US
5,1993,44739,2640,47379,US
6,1993,44873,2780,47653,US
7,1993,44848,2769,47617,US
8,1993,44820,2780,47600,US
9,1993,44762,2743,47505,US
10,1993,44707,2715,47422,US
11,1993,44026,2695,46721,US
12,1993,43888,2779,46667,US
1,1994,43449,2953,46402,US
2,1994,41154,5120,46274,US
3,1994,40849,5276,46125,US
4,1994,40698,5272,45970,US
5,1994,40496,5333,45829,US
6,1994,40261,5449,45710,US
7,1994,40367,5565,45932,US
8,1994,39832,5621,45453,US
9,1994,39733,5715,45448,US
10,1994,39672,5359,45031,US
11,1994,39574,5433,45007,US
12,1994,39444,5600,45044,US
1,1995,39202,5570,44772,US
2,1995,39065,5506,44571,US
3,1995,38823,5679,44502,US
4,1995,38625,5632,44257,US
5,1995,38389,5531,43920,US
6,1995,38011,5603,43614,US
7,1995,37850,5585,43435,US
8,1995,37362,5515,42877,US
9,1995,37535,5440,42975,US
10,1995,37245,5377,42622,US
11,1995,37133,5361,42494,US
12,1995,37037,5355,42392,US
1,1996,36610,5303,41913,US
2,1996,36691,5227,41918,US
3,1996,36784,5197,41981,US
4,1996,36750,5114,41864,US
5,1996,36883,5139,42022,US
6,1996,36317,5221,41538,US
7,1996,36923,5351,42274,US
8,1996,36873,5237,42110,US
9,1996,36945,5244,42189,US
10,1996,36874,5228,42102,US
11,1996,36984,5187,42171,US
12,1996,37047,5197,42244,US
1,1997,37263,5048,42311,US
2,1997,37487,4978,42465,US
3,1997,37504,4921,42425,US
4,1997,37640,4864,42504,US
5,1997,37554,4826,42380,US
6,1997,37578,4742,42320,US
7,1997,37674,4643,42317,US
8,1997,37605,4601,42206,US
9,1997,37661,4498,42159,US
10,1997,37148,4543,41691,US
11,1997,37033,4571,41604,US
12,1997,36218,4647,40865,US
1,1998,36150,4653,40803,US
2,1998,36202,4646,40848,US
3,1998,36256,4718,40974,US
4,1998,36248,4871,41119,US
5,1998,36196,4864,41060,US
6,1998,36027,4819,40846,US
7,1998,36103,4709,40812,US
8,1998,36136,4634,40770,US
9,1998,36060,4600,40660,US
10,1998,36060,4600,40660,US
11,1998,36170,4557,40727,US
12,1998,36088,4576,40664,US
1,1999,36107,4547,40654,US
2,1999,36211,4510,40721,US
3,1999,36653,4314,40967,US
4,1999,36731,4346,41077,US
5,1999,36976,4356,41332,US
6,1999,37186,4441,41627,US
7,1999,37694,4529,42223,US
8,1999,38088,4617,42705,US
9,1999,38351,4657,43008,US
10,1999,38618,4707,43325,US
11,1999,39093,4634,43727,US
12,1999,39354,4668,44022,US
1,2000,39652,4680,44332,US
2,2000,39981,4651,44632,US
3,2000,40053,4574,44627,US
4,2000,40411,4523,44934,US
5,2000,40407,4503,44910,US
6,2000,42354,2673,45027,US
7,2000,42397,2712,45109,US
8,2000,41166,4196,45362,US
9,2000,41262,4163,45425,US
10,2000,41368,4607,45975,US
11,2000,41502,4141,45643,US
12,2000,41708,4125,45833,US
1,2001,41716,4508,46224,US
2,2001,41924,4145,46069,US
3,2001,42043,4140,46183,US
4,2001,42138,4108,46246,US
5,2001,42334,4158,46492,US
6,2001,42411,4546,46957,US
7,2001,42266,4472,46738,US
8,2001,42194,4385,46579,US
9,2001,40749,4320,45069,US
10,2001,38225,3035,41260,US
11,2001,36876,3401,40277,US
12,2001,33820,3275,37095,US
1,2002,32985,3295,36280,US
2,2002,32580,2960,35540,US
3,2002,32425,3242,35667,US
4,2002,32205,3320,35525,US
5,2002,32571,3300,35871,US
6,2002,32449,3408,35857,US
7,2002,32267,3422,35689,US
8,2002,32160,3364,35524,US
9,2002,31674,1628,33302,US
10,2002,31276,3223,34499,US
11,2002,29720,3161,32881,US
12,2002,28612,3093,31705,US
1,2003,26294,3052,29346,US
2,2003,26182,3013,29195,US
3,2003,25865,3075,28940,US
4,2003,25543,2993,28536,US
5,2003,25282,2983,28265,US
6,2003,24816,3175,27991,US
7,2003,24778,3206,27984,US
8,2003,24770,3286,28056,US
9,2003,24628,3284,27912,US
10,2003,24747,3294,28041,US
11,2003,24737,3328,28065,US
12,2003,25072,3294,28366,US
1,2004,24892,3297,28189,US
2,2004,24638,3288,27926,US
3,2004,24612,3280,27892,US
4,2004,24401,3348,27749,US
5,2004,24261,3341,27602,US
6,2004,24392,3345,27737,US
7,2004,24256,3344,27600,US
8,2004,24197,3308,27505,US
9,2004,24028,3287,27315,US
10,2004,23727,3204,26931,US
11,2004,23268,3075,26343,US
12,2004,23180,2989,26169,US
1,2005,22621,2986,25607,US
2,2005,22460,2985,25445,US
3,2005,22182,3030,25212,US
4,2005,20759,3070,23829,US
5,2005,20549,3023,23572,US
6,2005,20720,3008,23728,US
7,2005,20182,3065,23247,US
8,2005,19732,3102,22834,US
9,2005,19102,3122,22224,US
10,2005,18876,3115,21991,US
11,2005,18614,3141,21755,US
12,2005,18556,3108,21664,US
1,2006,18330,3120,21450,US
2,2006,18217,3093,21310,US
3,2006,17972,3116,21088,US
4,2006,17937,3129,21066,US
5,2006,17683,3077,20760,US
6,2006,17733,3027,20760,US
7,2006,17618,3091,20709,US
8,2006,17549,3173,20722,US
9,2006,17553,3255,20808,US
10,2006,17626,3242,20868,US
11,2006,17717,3266,20983,US
12,2006,17800,3243,21043,US
1,2007,17934,3188,21122,US
2,2007,17942,3189,21131,US
3,2007,18075,3213,21288,US
4,2007,18087,3215,21302,US
5,2007,18709,3367,22076,US
6,2007,18785,3239,22024,US
7,2007,18784,3230,22014,US
8,2007,18846,3188,22034,US
9,2007,18818,3146,21964,US
10,2007,29769,6221,35990,US
11,2007,29755,6088,35843,US
12,2007,29671,6071,35742,US
1,2008,29640,6067,35707,US
2,2008,29904,5847,35751,US
3,2008,29930,5772,35702,US
4,2008,30139,5708,35847,US
5,2008,30238,5700,35938,US
6,2008,30116,5603,35719,US
7,2008,29871,5479,35350,US
8,2008,29549,5410,34959,US
9,2008,28862,4917,33779,US
10,2008,28804,4851,33655,US
11,2008,28729,4865,33594,US
12,2008,28965,4844,33809,US
1,2009,28827,4814,33641,US
2,2009,28805,4792,33597,US
3,2009,28840,4737,33577,US
4,2009,28831,4737,33568,US
5,2009,28840,4641,33481,US
6,2009,28742,4633,33375,US
7,2009,28874,4588,33462,US
8,2009,28334,4561,32895,US
9,2009,28016,4378,32394,US
10,2009,27854,4248,32102,US
11,2009,27831,4209,32040,US
12,2009,27847,4174,32021,US
1,2010,27778,4138,31916,US
2,2010,27541,3942,31483,US
3,2010,27491,3929,31420,US
4,2010,27501,3949,31450,US
5,2010,27576,3902,31478,US
6,2010,27545,3933,31478,US
7,2010,27492,3913,31405,US
8,2010,27439,3873,31312,US
9,2010,27472,3850,31322,US
10,2010,27559,3831,31390,US
11,2010,27689,3852,31541,US
12,2010,27685,3841,31526,US
1,2011,27785,3832,31617,US
2,2011,27821,3802,31623,US
3,2011,27921,3738,31659,US
4,2011,28101,3761,31862,US
5,2011,28122,3825,31947,US
6,2011,28112,3796,31908,US
7,2011,28287,3808,32095,US
8,2011,28324,3848,32172,US
9,2011,28389,3845,32234,US
10,2011,28688,3831,32519,US
11,2011,28745,3811,32556,US
12,2011,28584,3764,32348,US
1,2012,28529,3722,32251,US
2,2012,28529,3728,32257,US
3,2012,28426,3774,32200,US
4,2012,28485,3804,32289,US
5,2012,28529,3797,32326,US
6,2012,28508,3769,32277,US
7,2012,28487,3773,32260,US
8,2012,28469,3752,32221,US
9,2012,28535,3764,32299,US
10,2012,28467,3798,32265,US
11,2012,28473,3819,32292,US
12,2012,28418,3784,32202,US
1,2013,28418,3800,32218,US
2,2013,28609,3796,32405,US
3,2013,28789,3834,32623,US
4,2013,28916,3923,32839,US
5,2013,29040,3882,32922,US
6,2013,29085,3869,32954,US
7,2013,29200,3879,33079,US
8,2013,29250,3859,33109,US
9,2013,29371,3879,33250,US
10,2013,29431,3865,33296,US
11,2013,29600,3796,33396,US
12,2013,29586,3755,33341,US
1,2014,29647,3854,33501,US
2,2014,29644,3920,33564,US
3,2014,29668,3990,33658,US
4,2014,29690,3949,33639,US
5,2014,29811,3950,33761,US
6,2014,29849,3952,33801,US
7,2014,29700,3977,33677,US
8,2014,29544,3971,33515,US
9,2014,29648,4039,33687,US
10,2014,29625,4017,33642,US
11,2014,29695,4009,33704,US
12,2014,29807,3911,33718,US
1,2015,30050,3927,33977,US
2,2015,30218,4015,34233,US
3,2015,30408,4257,34665,US
4,2015,30722,4492,35214,US
5,2015,30832,4514,35346,US
6,2015,30816,4523,35339,US
8,2007,488,37,525,VX
9,2007,544,43,587,VX
10,2007,644,59,703,VX
11,2007,690,61,751,VX
12,2007,710,50,760,VX
1,2008,735,49,784,VX
2,2008,794,68,862,VX
3,2008,857,70,927,VX
4,2008,761,59,820,VX
5,2008,1085,76,1161,VX
6,2008,1150,78,1228,VX
7,2008,1160,80,1240,VX
8,2008,1108,85,1193,VX
9,2008,1133,86,1219,VX
10,2008,1174,91,1265,VX
11,2008,1213,96,1309,VX
12,2008,1213,92,1305,VX
1,2009,1255,90,1345,VX
2,2009,1294,99,1393,VX
3,2009,1345,101,1446,VX
4,2009,1375,106,1481,VX
5,2009,1368,109,1477,VX
6,2009,1391,116,1507,VX
7,2009,1387,115,1502,VX
8,2009,1394,112,1506,VX
9,2009,1379,113,1492,VX
10,2009,1362,122,1484,VX
11,2009,1362,123,1485,VX
12,2009,1360,121,1481,VX
1,2010,1421,129,1550,VX
2,2010,1449,121,1570,VX
3,2010,1455,140,1595,VX
4,2010,1470,114,1584,VX
5,2010,1465,124,1589,VX
6,2010,1504,144,1648,VX
7,2010,1503,139,1642,VX
8,2010,1553,161,1714,VX
9,2010,1575,159,1734,VX
10,2010,1626,168,1794,VX
11,2010,1673,185,1858,VX
12,2010,1676,187,1863,VX
1,2011,1703,183,1886,VX
2,2011,1735,185,1920,VX
3,2011,1715,216,1931,VX
4,2011,1750,183,1933,VX
5,2011,1850,206,2056,VX
6,2011,1879,205,2084,VX
7,2011,1838,223,2061,VX
8,2011,1879,201,2080,VX
9,2011,1918,207,2125,VX
10,2011,1947,217,2164,VX
11,2011,1967,248,2215,VX
12,2011,1988,248,2236,VX
1,2012,2086,240,2326,VX
2,2012,2188,233,2421,VX
3,2012,2232,254,2486,VX
4,2012,2267,251,2518,VX
5,2012,2308,269,2577,VX
6,2012,2307,276,2583,VX
7,2012,2307,288,2595,VX
8,2012,2306,292,2598,VX
9,2012,2311,285,2596,VX
10,2012,2294,277,2571,VX
11,2012,2274,266,2540,VX
12,2012,2248,261,2509,VX
1,2013,2239,263,2502,VX
2,2013,2223,257,2480,VX
3,2013,2256,260,2516,VX
4,2013,2274,292,2566,VX
5,2013,2263,323,2586,VX
6,2013,2243,323,2566,VX
7,2013,2250,320,2570,VX
8,2013,2261,311,2572,VX
9,2013,2289,341,2630,VX
10,2013,2316,359,2675,VX
11,2013,2310,355,2665,VX
12,2013,2299,361,2660,VX
1,2014,2327,335,2662,VX
2,2014,2344,332,2676,VX
3,2014,2337,335,2672,VX
4,2014,2366,321,2687,VX
5,2014,2348,323,2671,VX
6,2014,2345,330,2675,VX
7,2014,2354,328,2682,VX
8,2014,2343,329,2672,VX
9,2014,2348,353,2701,VX
10,2014,2350,339,2689,VX
11,2014,2347,347,2694,VX
12,2014,2330,342,2672,VX
1,2015,2361,334,2695,VX
2,2015,2381,341,2722,VX
3,2015,2379,349,2728,VX
4,2015,2421,362,2783,VX
5,2015,2418,363,2781,VX
6,2015,2438,358,2796,VX
7,2015,2489,344,2833,VX
8,2015,2535,334,2869,VX
9,2015,2514,348,2862,VX
10,2015,2537,346,2883,VX
11,2015,2582,347,2929,VX
12,2015,2558,353,2911,VX
1,2016,2566,344,2910,VX
2,2016,2632,375,3007,VX
3,2016,2671,361,3032,VX
4,2016,2708,369,3077,VX
5,2016,2716,374,3090,VX
6,2016,2745,364,3109,VX
7,2016,2758,367,3125,VX
8,2016,2778,363,3141,VX
9,2016,2764,363,3127,VX
10,2016,2812,363,3175,VX
11,2016,2807,371,3178,VX
12,2016,2787,357,3144,VX
1,2017,2783,358,3141,VX
2,2017,2833,363,3196,VX
3,2017,2852,347,3199,VX
4,2017,2874,350,3224,VX
5,2017,2908,399,3307,VX
6,2017,2879,386,3265,VX
7,2017,2912,438,3350,VX
8,2017,2928,426,3354,VX
9,2017,2925,442,3367,VX
10,2017,3001,475,3476,VX
11,2017,2994,461,3455,VX
12,2017,2892,447,3339,VX
1,1990,6997,832,7829,WN
2,1990,6996,833,7829,WN
3,1990,7090,833,7923,WN
4,1990,7772,173,7945,WN
5,1990,8049,164,8213,WN
6,1990,8224,165,8389,WN
7,1990,8297,157,8454,WN
8,1990,8310,150,8460,WN
9,1990,8325,152,8477,WN
10,1990,8416,142,8558,WN
11,1990,8463,137,8600,WN
12,1990,8486,134,8620,WN
1,1991,8503,137,8640,WN
2,1991,8667,134,8801,WN
3,1991,8671,135,8806,WN
4,1991,8892,134,9026,WN
5,1991,9074,136,9210,WN
6,1991,9170,131,9301,WN
7,1991,9249,130,9379,WN
8,1991,9312,114,9426,WN
9,1991,9396,111,9507,WN
10,1991,9462,101,9563,WN
11,1991,9570,111,9681,WN
12,1991,9687,91,9778,WN
1,1992,9784,83,9867,WN
2,1992,9902,91,9993,WN
3,1992,10152,86,10238,WN
4,1992,10520,85,10605,WN
5,1992,10702,80,10782,WN
6,1992,10709,73,10782,WN
7,1992,11277,73,11350,WN
8,1992,11329,73,11402,WN
9,1992,11373,67,11440,WN
10,1992,11520,66,11586,WN
11,1992,11563,60,11623,WN
12,1992,11453,56,11509,WN
1,1993,11491,56,11547,WN
2,1993,11675,57,11732,WN
3,1993,11835,55,11890,WN
4,1993,12101,55,12156,WN
5,1993,12357,53,12410,WN
6,1993,12541,54,12595,WN
7,1993,12766,53,12819,WN
8,1993,12844,54,12898,WN
9,1993,12948,50,12998,WN
10,1993,12967,49,13016,WN
11,1993,13174,53,13227,WN
12,1993,13232,52,13284,WN
1,1994,13267,50,13317,WN
2,1994,13407,52,13459,WN
3,1994,13730,48,13778,WN
4,1994,13833,45,13878,WN
5,1994,14747,46,14793,WN
6,1994,14992,47,15039,WN
7,1994,15260,48,15308,WN
8,1994,15482,50,15532,WN
9,1994,15793,46,15839,WN
10,1994,16125,50,16175,WN
11,1994,16369,47,16416,WN
12,1994,16597,49,16646,WN
1,1995,17089,46,17135,WN
2,1995,17524,47,17571,WN
3,1995,17970,45,18015,WN
4,1995,18271,43,18314,WN
5,1995,18488,41,18529,WN
6,1995,18944,42,18986,WN
7,1995,19101,195,19296,WN
8,1995,19181,320,19501,WN
9,1995,19270,478,19748,WN
10,1995,19337,577,19914,WN
11,1995,19454,635,20089,WN
12,1995,19546,774,20320,WN
1,1996,19880,684,20564,WN
2,1996,20008,668,20676,WN
3,1996,20477,653,21130,WN
4,1996,20889,670,21559,WN
5,1996,21245,665,21910,WN
6,1996,21526,762,22288,WN
7,1996,21757,816,22573,WN
8,1996,21821,828,22649,WN
9,1996,22624,884,23508,WN
10,1996,22457,862,23319,WN
11,1996,22534,904,23438,WN
12,1996,22493,902,23395,WN
1,1997,22839,887,23726,WN
2,1997,23027,880,23907,WN
3,1997,23544,436,23980,WN
4,1997,23227,849,24076,WN
5,1997,23265,876,24141,WN
6,1997,23329,897,24226,WN
7,1997,23394,911,24305,WN
8,1997,23358,895,24253,WN
9,1997,23407,866,24273,WN
10,1997,23385,886,24271,WN
11,1997,23568,955,24523,WN
12,1997,23494,960,24454,WN
1,1998,23570,890,24460,WN
2,1998,23526,850,24376,WN
3,1998,23729,844,24573,WN
4,1998,23805,827,24632,WN
5,1998,23833,818,24651,WN
6,1998,23967,840,24807,WN
7,1998,24155,809,24964,WN
8,1998,24885,405,25290,WN
9,1998,24610,818,25428,WN
10,1998,24898,819,25717,WN
11,1998,25198,890,26088,WN
12,1998,25392,904,26296,WN
1,1999,25424,857,26281,WN
2,1999,26280,884,27164,WN
3,1999,26104,857,26961,WN
4,1999,26009,837,26846,WN
5,1999,26179,857,27036,WN
6,1999,26386,864,27250,WN
7,1999,26681,880,27561,WN
8,1999,26804,864,27668,WN
9,1999,26742,845,27587,WN
10,1999,27049,862,27911,WN
11,1999,27200,878,28078,WN
12,1999,27211,884,28095,WN
1,2000,27316,854,28170,WN
2,2000,27500,840,28340,WN
3,2000,27481,860,28341,WN
4,2000,27601,858,28459,WN
5,2000,27514,852,28366,WN
6,2000,27403,850,28253,WN
7,2000,27593,878,28471,WN
8,2000,27821,826,28647,WN
9,2000,27916,810,28726,WN
10,2000,28329,830,29159,WN
11,2000,28626,829,29455,WN
12,2000,28860,828,29688,WN
1,2001,28887,813,29700,WN
2,2001,29060,810,29870,WN
3,2001,29160,800,29960,WN
4,2001,29498,793,30291,WN
5,2001,29781,779,30560,WN
6,2001,29996,746,30742,WN
7,2001,30367,748,31115,WN
8,2001,30478,731,31209,WN
9,2001,30580,733,31313,WN
10,2001,30749,739,31488,WN
11,2001,31049,728,31777,WN
12,2001,31945,729,32674,WN
1,2002,31282,725,32007,WN
2,2002,31538,720,32258,WN
3,2002,31875,739,32614,WN
4,2002,32316,742,33058,WN
5,2002,32351,726,33077,WN
6,2002,32790,718,33508,WN
7,2002,33151,732,33883,WN
8,2002,33261,726,33987,WN
9,2002,33271,676,33947,WN
10,2002,33347,722,34069,WN
11,2002,33800,742,34542,WN
12,2002,33322,766,34088,WN
1,2003,33062,730,33792,WN
2,2003,33141,771,33912,WN
3,2003,32776,728,33504,WN
4,2003,32692,761,33453,WN
5,2003,32612,794,33406,WN
6,2003,32481,842,33323,WN
7,2003,32636,852,33488,WN
8,2003,32307,855,33162,WN
9,2003,32146,834,32980,WN
10,2003,32164,858,33022,WN
11,2003,32334,905,33239,WN
12,2003,32394,906,33300,WN
1,2004,32054,859,32913,WN
2,2004,31257,708,31965,WN
3,2004,31202,640,31842,WN
4,2004,31219,624,31843,WN
5,2004,31091,622,31713,WN
6,2004,31081,655,31736,WN
7,2004,31317,718,32035,WN
8,2004,30615,539,31154,WN
9,2004,30387,540,30927,WN
10,2004,30399,529,30928,WN
11,2004,31245,535,31780,WN
12,2004,30749,525,31274,WN
1,2005,30753,515,31268,WN
2,2005,30685,498,31183,WN
3,2005,30728,493,31221,WN
4,2005,30813,489,31302,WN
5,2005,30995,493,31488,WN
6,2005,31110,512,31622,WN
7,2005,31176,504,31680,WN
8,2005,31214,497,31711,WN
9,2005,31134,496,31630,WN
10,2005,31013,503,31516,WN
11,2005,31393,507,31900,WN
12,2005,31472,514,31986,WN
1,2006,31177,506,31683,WN
2,2006,31210,504,31714,WN
3,2006,31142,509,31651,WN
4,2006,31377,502,31879,WN
5,2006,31433,502,31935,WN
6,2006,31482,505,31987,WN
7,2006,31477,507,31984,WN
8,2006,31849,491,32340,WN
9,2006,31903,482,32385,WN
10,2006,32238,479,32717,WN
11,2006,32354,479,32833,WN
12,2006,32429,470,32899,WN
1,2007,32255,470,32725,WN
2,2007,32594,470,33064,WN
3,2007,32728,467,33195,WN
4,2007,32891,479,33370,WN
5,2007,32993,474,33467,WN
6,2007,33023,475,33498,WN
7,2007,33309,490,33799,WN
8,2007,33400,477,33877,WN
9,2007,33544,485,34029,WN
10,2007,33620,511,34131,WN
11,2007,33845,516,34361,WN
12,2007,34105,545,34650,WN
1,2008,33910,552,34462,WN
2,2008,33794,552,34346,WN
3,2008,33567,655,34222,WN
4,2008,33729,655,34384,WN
5,2008,33576,666,34242,WN
6,2008,33681,692,34373,WN
7,2008,33925,719,34644,WN
8,2008,34971,673,35644,WN
9,2008,35194,701,35895,WN
10,2008,35321,687,36008,WN
11,2008,35313,710,36023,WN
12,2008,35146,706,35852,WN
1,2009,35167,712,35879,WN
2,2009,35187,711,35898,WN
3,2009,35154,715,35869,WN
4,2009,35078,723,35801,WN
5,2009,35049,723,35772,WN
6,2009,34938,716,35654,WN
7,2009,34580,701,35281,WN
8,2009,34324,672,34996,WN
9,2009,34477,657,35134,WN
10,2009,34420,656,35076,WN
11,2009,34439,642,35081,WN
12,2009,34409,633,35042,WN
1,2010,34475,632,35107,WN
2,2010,34424,612,35036,WN
3,2010,34327,619,34946,WN
4,2010,34278,588,34866,WN
5,2010,34309,607,34916,WN
6,2010,34309,653,34962,WN
7,2010,34313,688,35001,WN
8,2010,34410,715,35125,WN
9,2010,34482,707,35189,WN
10,2010,34621,737,35358,WN
11,2010,34614,781,35395,WN
12,2010,34506,790,35296,WN
1,2011,34740,806,35546,WN
2,2011,34977,759,35736,WN
3,2011,35065,773,35838,WN
4,2011,35260,767,36027,WN
5,2011,35489,786,36275,WN
6,2011,35835,794,36629,WN
7,2011,36054,827,36881,WN
8,2011,36322,830,37152,WN
9,2011,36711,833,37544,WN
10,2011,36939,820,37759,WN
11,2011,37167,850,38017,WN
12,2011,37202,877,38079,WN
1,2012,37741,923,38664,WN
2,2012,37990,955,38945,WN
3,2012,38336,993,39329,WN
4,2012,45405,1437,46842,WN
5,2012,45438,1476,46914,WN
6,2012,45391,1473,46864,WN
7,2012,45208,1490,46698,WN
8,2012,45016,1466,46482,WN
9,2012,45301,1494,46795,WN
10,2012,45277,1476,46753,WN
11,2012,45204,1497,46701,WN
12,2012,45128,1466,46594,WN
1,2013,45121,1428,46549,WN
2,2013,45145,1424,46569,WN
3,2013,45078,1426,46504,WN
4,2013,44860,1459,46319,WN
5,2013,44796,1404,46200,WN
6,2013,44543,1345,45888,WN
7,2013,44464,1328,45792,WN
8,2013,44327,1345,45672,WN
9,2013,44476,1343,45819,WN
10,2013,44391,1366,45757,WN
11,2013,44246,1330,45576,WN
12,2013,44158,1346,45504,WN
1,2014,44318,1329,45647,WN
2,2014,44430,1321,45751,WN
3,2014,44492,1341,45833,WN
4,2014,44533,1368,45901,WN
5,2014,44653,1377,46030,WN
6,2014,44814,1388,46202,WN
7,2014,44815,1415,46230,WN
8,2014,44871,1396,46267,WN
9,2014,45020,1459,46479,WN
10,2014,45349,1492,46841,WN
11,2014,45552,1494,47046,WN
12,2014,45533,1490,47023,WN
1,2015,45840,1495,47335,WN
2,2015,46016,1536,47552,WN
3,2015,46219,1571,47790,WN
4,2015,46363,1631,47994,WN
5,2015,46678,1635,48313,WN
6,2015,46808,1674,48482,WN
7,2015,47054,1642,48696,WN
8,2015,47329,1679,49008,WN
9,2015,47774,1736,49510,WN
10,2015,48313,1707,50020,WN
11,2015,48744,1668,50412,WN
12,2015,48757,1652,50409,WN
1,2016,49127,1707,50834,WN
2,2016,49575,1747,51322,WN
3,2016,50021,1779,51800,WN
4,2016,50558,1770,52328,WN
5,2016,50985,1805,52790,WN
6,2016,51413,1775,53188,WN
7,2016,51650,1789,53439,WN
8,2016,51920,1837,53757,WN
9,2016,52122,1899,54021,WN
10,2016,52504,1952,54456,WN
11,2016,52727,1902,54629,WN
12,2016,52620,1831,54451,WN
1,2017,53120,1861,54981,WN
2,2017,53622,1858,55480,WN
3,2017,53726,1852,55578,WN
4,2017,53910,1851,55761,WN
5,2017,54190,1850,56040,WN
6,2017,54439,1816,56255,WN
7,2017,54455,1801,56256,WN
8,2017,54503,1862,56365,WN
9,2017,54730,1882,56612,WN
10,2017,55068,1839,56907,WN
11,2017,55103,1927,57030,WN
12,2017,55143,1934,57077,WN
1,2018,55486,2081,57567,WN
2,2018,55776,2117,57893,WN
3,2018,56036,2152,58188,WN
4,2018,56367,2232,58599,WN
5,2018,56614,2218,58832,WN
6,2018,56550,2248,58798,WN
7,2018,56678,2375,59053,WN
8,2018,56928,2414,59342,WN
9,2018,57369,2380,59749,WN
10,2018,57599,2376,59975,WN
11,2018,57679,2346,60025,WN
12,2018,57624,2358,59982,WN
1,2019,57902,2361,60263,WN
2,2019,58156,2292,60448,WN
3,2019,58312,2247,60559,WN
4,2019,58474,2255,60729,WN
5,2019,58517,2240,60757,WN
6,2019,58698,2190,60888,WN
7,2019,58873,2184,61057,WN
8,2019,59053,2235,61288,WN
9,2019,59453,2274,61727,WN
10,2019,59657,2308,61965,WN
11,2019,59605,2282,61887,WN
12,2019,59629,2276,61905,WN
1,2020,59914,2302,62216,WN
2,2020,60092,2344,62436,WN
3,2020,59763,2318,62081,WN
4,2020,59866,2325,62191,WN
5,2020,60012,2333,62345,WN
6,2020,59947,2341,62288,WN
7,2020,59726,2318,62044,WN
8,2020,59355,2333,61688,WN
9,2020,56834,2194,59028,WN
10,2020,55992,2142,58134,WN
11,2020,55845,2109,57954,WN
12,2020,55500,2074,57574,WN
1,2021,55370,2055,57425,WN
2,2021,55325,2019,57344,WN
3,2021,55065,1972,57037,WN
4,2021,54761,1919,56680,WN
5,2021,54191,1832,56023,WN
6,2021,53602,1691,55293,WN
7,2021,53197,1615,54812,WN
8,2021,53039,1473,54512,WN
9,2021,53269,1429,54698,WN
10,2021,53367,1381,54748,WN
11,2021,53926,1335,55261,WN
12,2021,54439,1307,55746,WN
1,2022,55602,1276,56878,WN
2,2022,56945,1240,58185,WN
3,2022,58270,1189,59459,WN
4,2022,59705,1212,60917,WN
5,2022,60737,1303,62040,WN
6,2022,61619,1428,63047,WN
7,2022,62448,1570,64018,WN
8,2022,62677,1673,64350,WN
9,2022,63238,1770,65008,WN
10,2022,64297,1818,66115,WN
11,2022,65424,1632,67056,WN
12,2022,65881,1549,67430,WN
1,2023,66965,1523,68488,WN
2,2023,68154,1468,69622,WN
3,2023,69137,1462,70599,WN
4,2023,69770,1526,71296,WN
5,2023,70132,1455,71587,WN
6,2023,70590,1417,72007,WN
7,2023,71846,1349,73195,WN
8,2023,72659,1340,73999,WN
9,2023,73480,1401,74881,WN
10,2023,73998,1371,75369,WN
11,2023,74294,1384,75678,WN
12,2023,74046,1519,75565,WN
1,2024,74033,1672,75705,WN
2,2024,73967,1780,75747,WN
3,2024,73734,1921,75655,WN
4,2024,73783,2128,75911,WN
5,2024,73462,2155,75617,WN
6,2024,72946,2270,75216,WN
7,2024,72564,2333,74897,WN
8,2024,72299,2311,74610,WN
9,2024,72276,2374,74650,WN
10,2024,72259,2555,74814,WN
11,2024,71877,2557,74434,WN
12,2024,71206,2487,73693,WN
1,2025,71331,2556,73887,WN
7,1995,2122,339,2461,YV
8,1995,2120,335,2455,YV
9,1995,2094,326,2420,YV
10,1995,2112,343,2455,YV
11,1995,2112,342,2454,YV
12,1995,2120,341,2461,YV
1,1996,2230,342,2572,YV
2,1996,2228,340,2568,YV
3,1996,1896,291,2187,YV
4,1996,1986,295,2281,YV
5,1996,1995,297,2292,YV
6,1996,1985,289,2274,YV
7,1996,2050,287,2337,YV
8,1996,2051,287,2338,YV
9,1996,2049,280,2329,YV
10,1996,2035,285,2320,YV
11,1996,2035,285,2320,YV
12,1996,2030,270,2300,YV
1,1997,2078,284,2362,YV
2,1997,2125,290,2415,YV
3,1997,2130,281,2411,YV
4,1997,2250,290,2540,YV
5,1997,2256,292,2548,YV
6,1997,2290,301,2591,YV
1,2004,3041,302,3343,YV
2,2004,3219,317,3536,YV
3,2004,3023,323,3346,YV
4,2004,3008,313,3321,YV
5,2004,3446,318,3764,YV
6,2004,3516,332,3848,YV
7,2004,3565,355,3920,YV
8,2004,3664,355,4019,YV
9,2004,3675,381,4056,YV
10,2004,3665,383,4048,YV
11,2004,3638,414,4052,YV
12,2004,3627,410,4037,YV
1,2005,3208,43,3251,YV
2,2005,3156,43,3199,YV
3,2005,3202,42,3244,YV
4,2005,3259,40,3299,YV
5,2005,3273,44,3317,YV
6,2005,3275,38,3313,YV
7,2005,3296,36,3332,YV
8,2005,3313,34,3347,YV
9,2005,3323,40,3363,YV
10,2005,3369,44,3413,YV
11,2005,2940,45,2985,YV
12,2005,2952,45,2997,YV
1,2006,3184,48,3232,YV
2,2006,3196,51,3247,YV
3,2006,3195,53,3248,YV
4,2006,3174,55,3229,YV
5,2006,3157,54,3211,YV
6,2006,3245,55,3300,YV
7,2006,3348,56,3404,YV
8,2006,3348,60,3408,YV
9,2006,3360,58,3418,YV
10,2006,3152,49,3201,YV
11,2006,3267,34,3301,YV
12,2006,3209,61,3270,YV
1,2007,3195,66,3261,YV
2,2007,3213,62,3275,YV
3,2007,3233,62,3295,YV
4,2007,3226,60,3286,YV
5,2007,3179,57,3236,YV
6,2007,3190,58,3248,YV
7,2007,3135,58,3193,YV
8,2007,3174,57,3231,YV
9,2007,3205,57,3262,YV
10,2007,3200,59,3259,YV
11,2007,3161,56,3217,YV
12,2007,3064,53,3117,YV
1,2008,2987,55,3042,YV
2,2008,2910,53,2963,YV
3,2008,2893,61,2954,YV
4,2008,2883,61,2944,YV
5,2008,2900,57,2957,YV
6,2008,2870,56,2926,YV
7,2008,2962,59,3021,YV
8,2008,3003,59,3062,YV
9,2008,2912,59,2971,YV
10,2008,2894,59,2953,YV
11,2008,2907,58,2965,YV
12,2008,2884,56,2940,YV
1,2009,2849,57,2906,YV
2,2009,2824,53,2877,YV
3,2009,2812,52,2864,YV
4,2009,2773,48,2821,YV
5,2009,2774,43,2817,YV
6,2009,2706,42,2748,YV
7,2009,2669,42,2711,YV
8,2009,2635,40,2675,YV
9,2009,2588,40,2628,YV
10,2009,2560,44,2604,YV
11,2009,2579,40,2619,YV
12,2009,2497,43,2540,YV
1,2010,2389,39,2428,YV
2,2010,2308,39,2347,YV
3,2010,2180,37,2217,YV
4,2010,2156,39,2195,YV
5,2010,2049,39,2088,YV
6,2010,2059,36,2095,YV
7,2010,1990,35,2025,YV
8,2010,2036,31,2067,YV
9,2010,2125,32,2157,YV
10,2010,2077,30,2107,YV
11,2010,2048,31,2079,YV
12,2010,2030,29,2059,YV
1,2011,2009,26,2035,YV
2,2011,1977,26,2003,YV
3,2011,1966,26,1992,YV
4,2011,1949,24,1973,YV
5,2011,1964,78,2042,YV
6,2011,1925,20,1945,YV
7,2011,1927,20,1947,YV
8,2011,1902,11,1913,YV
9,2011,1886,26,1912,YV
10,2011,1827,26,1853,YV
11,2011,1821,27,1848,YV
12,2011,1796,28,1824,YV
1,2012,1801,27,1828,YV
2,2012,1795,25,1820,YV
3,2012,1740,22,1762,YV
4,2012,1732,22,1754,YV
5,2012,1738,21,1759,YV
6,2012,1717,18,1735,YV
7,2012,1673,16,1689,YV
8,2012,1724,15,1739,YV
9,2012,1643,13,1656,YV
10,2012,1638,9,1647,YV
11,2012,1571,8,1579,YV
12,2012,1537,6,1543,YV
1,2013,1539,6,1545,YV
2,2013,1538,5,1543,YV
3,2013,1542,5,1547,YV
4,2013,1608,5,1613,YV
5,2013,1645,4,1649,YV
6,2013,1707,5,1712,YV
7,2013,1715,5,1720,YV
8,2013,1719,5,1724,YV
9,2013,1710,4,1714,YV
10,2013,1767,5,1772,YV
11,2013,1768,4,1772,YV
12,2013,1802,4,1806,YV
1,2014,1814,5,1819,YV
2,2014,1838,5,1843,YV
3,2014,1909,6,1915,YV
4,2014,1903,6,1909,YV
5,2014,1927,4,1931,YV
6,2014,1973,4,1977,YV
7,2014,2110,9,2119,YV
8,2014,2051,8,2059,YV
9,2014,2114,5,2119,YV
10,2014,2139,6,2145,YV
11,2014,2179,6,2185,YV
12,2014,2201,6,2207,YV
1,2015,2268,7,2275,YV
2,2015,2309,8,2317,YV
3,2015,2376,7,2383,YV
4,2015,2421,6,2427,YV
5,2015,2508,6,2514,YV
6,2015,2564,5,2569,YV
7,2015,2597,5,2602,YV
8,2015,2660,4,2664,YV
9,2015,2690,14,2704,YV
10,2015,2733,14,2747,YV
11,2015,2761,16,2777,YV
12,2015,2782,16,2798,YV
1,2016,2820,16,2836,YV
2,2016,2822,9,2831,YV
3,2016,2788,9,2797,YV
4,2016,2918,10,2928,YV
5,2016,2895,10,2905,YV
6,2016,2950,11,2961,YV
7,2016,3001,10,3011,YV
8,2016,3047,12,3059,YV
9,2016,3106,15,3121,YV
10,2016,3091,17,3108,YV
11,2016,3066,17,3083,YV
12,2016,3082,15,3097,YV
1,2017,3068,12,3080,YV
2,2017,3019,12,3031,YV
3,2017,3046,12,3058,YV
4,2017,3106,12,3118,YV
5,2017,3064,13,3077,YV
6,2017,3030,10,3040,YV
7,2017,3078,12,3090,YV
8,2017,3054,10,3064,YV
9,2017,3099,12,3111,YV
10,2017,3097,12,3109,YV
11,2017,3161,13,3174,YV
12,2017,3224,13,3237,YV
1,2018,3224,13,3237,YV
2,2018,3144,13,3157,YV
3,2018,3246,15,3261,YV
4,2018,3266,12,3278,YV
5,2018,3220,14,3234,YV
6,2018,3279,12,3291,YV
7,2018,3309,8,3317,YV
8,2018,3351,7,3358,YV
9,2018,3367,10,3377,YV
10,2018,3371,9,3380,YV
11,2018,3419,11,3430,YV
12,2018,3470,11,3481,YV
1,2019,3492,11,3503,YV
2,2019,3424,12,3436,YV
3,2019,3561,11,3572,YV
4,2019,3608,12,3620,YV
5,2019,3472,10,3482,YV
6,2019,3491,8,3499,YV
7,2019,3557,6,3563,YV
8,2019,3621,12,3633,YV
9,2019,3583,22,3605,YV
10,2019,3578,22,3600,YV
11,2019,3585,22,3607,YV
12,2019,3617,13,3630,YV
1,2020,3512,14,3526,YV
2,2020,3640,13,3653,YV
3,2020,3669,12,3681,YV
4,2020,3337,19,3356,YV
5,2020,3054,14,3068,YV
6,2020,2974,13,2987,YV
7,2020,2879,12,2891,YV
8,2020,2877,13,2890,YV
9,2020,2920,13,2933,YV
10,2020,2922,11,2933,YV
11,2020,2952,11,2963,YV
12,2020,3000,13,3013,YV
1,2021,2954,9,2963,YV
2,2021,3004,6,3010,YV
3,2021,3048,10,3058,YV
4,2021,3124,10,3134,YV
5,2021,3087,10,3097,YV
6,2021,3139,13,3152,YV
7,2021,3146,10,3156,YV
8,2021,3128,11,3139,YV
9,2021,3181,10,3191,YV
10,2021,3165,10,3175,YV
11,2021,3119,12,3131,YV
12,2021,3029,12,3041,YV
1,2022,2982,11,2993,YV
2,2022,2893,8,2901,YV
3,2022,2840,10,2850,YV
4,2022,2737,11,2748,YV
5,2022,2674,9,2683,YV
6,2022,2565,15,2580,YV
7,2022,2527,17,2544,YV
8,2022,2427,17,2444,YV
9,2022,2383,17,2400,YV
10,2022,2357,17,2374,YV
11,2022,2401,18,2419,YV
12,2022,2386,17,2403,YV
1,2023,2426,13,2439,YV
2,2023,2393,13,2406,YV
3,2023,2301,12,2313,YV
4,2023,2330,12,2342,YV
5,2023,2310,12,2322,YV
6,2023,2285,14,2299,YV
7,2023,2249,13,2262,YV
8,2023,2233,16,2249,YV
9,2023,2258,12,2270,YV
10,2023,2212,10,2222,YV
11,2023,2217,12,2229,YV
12,2023,2161,13,2174,YV
1,2024,2161,13,2174,YV
2,2024,2109,12,2121,YV
3,2024,2106,12,2118,YV
4,2024,2003,13,2016,YV
5,2024,1968,13,1981,YV
6,2024,1884,12,1896,YV
7,2024,1936,14,1950,YV
8,2024,1839,12,1851,YV
9,2024,1802,9,1811,YV
10,2024,1760,8,1768,YV
11,2024,1760,8,1768,YV
12,2024,1725,11,1736,YV
1,2025,1682,8,1690,YV
10,2005,141,0,141,YX
11,2005,185,2,187,YX
12,2005,244,3,247,YX
1,2006,311,3,314,YX
3,2006,394,4,398,YX
4,2006,453,9,462,YX
5,2006,537,11,548,YX
6,2006,556,8,564,YX
7,2006,555,11,566,YX
8,2006,577,9,586,YX
9,2006,596,10,606,YX
10,2006,584,11,595,YX
11,2006,635,10,645,YX
12,2006,662,15,677,YX
1,2007,666,21,687,YX
2,2007,773,22,795,YX
3,2007,833,23,856,YX
4,2007,909,23,932,YX
5,2007,913,22,935,YX
6,2007,1007,24,1031,YX
7,2007,985,25,1010,YX
8,2007,1036,22,1058,YX
9,2007,1102,20,1122,YX
10,2007,1137,22,1159,YX
11,2007,1212,23,1235,YX
1,2008,1322,26,1348,YX
2,2008,680,19,699,YX
3,2008,680,19,699,YX
4,2008,1464,25,1489,YX
5,2008,1464,25,1489,YX
6,2008,1337,26,1363,YX
7,2008,1254,28,1282,YX
8,2008,1254,30,1284,YX
9,2008,1288,30,1318,YX
10,2008,1278,28,1306,YX
11,2008,1407,31,1438,YX
12,2008,1403,29,1432,YX
1,2009,1403,29,1432,YX
2,2009,1458,38,1496,YX
3,2009,1458,38,1496,YX
4,2009,1414,35,1449,YX
5,2009,1443,35,1478,YX
6,2009,1480,35,1515,YX
7,2009,1538,37,1575,YX
8,2009,1576,38,1614,YX
9,2009,1656,38,1694,YX
10,2009,633,237,870,YX
11,2009,2627,475,3102,YX
12,2009,2440,468,2908,YX
1,2010,1881,70,1951,YX
2,2010,1889,72,1961,YX
3,2010,1939,69,2008,YX
4,2010,2017,63,2080,YX
5,2010,2023,68,2091,YX
6,2010,2044,68,2112,YX
7,2010,2056,73,2129,YX
8,2010,1936,75,2011,YX
9,2010,2039,75,2114,YX
10,2010,1970,70,2040,YX
11,2010,2067,73,2140,YX
12,2010,2069,71,2140,YX
1,2011,2088,77,2165,YX
2,2011,2107,77,2184,YX
3,2011,2157,76,2233,YX
4,2011,2158,76,2234,YX
5,2011,2139,80,2219,YX
6,2011,2120,80,2200,YX
7,2011,2097,76,2173,YX
8,2011,2062,79,2141,YX
9,2011,2042,82,2124,YX
10,2011,1987,81,2068,YX
11,2011,1934,75,2009,YX
12,2011,1911,75,1986,YX
1,2012,1931,70,2001,YX
2,2012,1943,68,2011,YX
3,2012,1949,69,2018,YX
4,2012,1848,62,1910,YX
5,2012,1873,60,1933,YX
6,2012,1884,65,1949,YX
7,2012,1910,64,1974,YX
8,2012,1953,68,2021,YX
9,2012,1977,69,2046,YX
10,2012,2022,69,2091,YX
11,2012,2080,69,2149,YX
12,2012,2100,74,2174,YX
1,2013,2121,77,2198,YX
2,2013,2188,76,2264,YX
3,2013,2236,74,2310,YX
4,2013,2256,77,2333,YX
5,2013,2275,77,2352,YX
6,2013,2299,89,2388,YX
7,2013,2371,84,2455,YX
8,2013,2427,88,2515,YX
9,2013,2504,84,2588,YX
10,2013,2561,78,2639,YX
11,2013,2593,79,2672,YX
12,2013,2608,78,2686,YX
1,2014,2707,79,2786,YX
2,2014,2712,80,2792,YX
3,2014,2726,81,2807,YX
4,2014,2780,82,2862,YX
5,2014,2852,82,2934,YX
6,2014,2870,84,2954,YX
7,2014,2897,90,2987,YX
8,2014,2908,91,2999,YX
9,2014,2961,95,3056,YX
10,2014,2996,93,3089,YX
11,2014,3019,94,3113,YX
12,2014,3075,94,3169,YX
1,2015,3093,95,3188,YX
2,2015,3105,89,3194,YX
3,2015,3115,89,3204,YX
4,2015,3122,95,3217,YX
5,2015,3161,97,3258,YX
6,2015,3110,115,3225,YX
7,2015,3090,117,3207,YX
8,2015,3050,114,3164,YX
9,2015,3007,118,3125,YX
10,2015,3045,116,3161,YX
11,2015,3039,115,3154,YX
12,2015,3070,107,3177,YX
1,2016,3078,110,3188,YX
2,2016,3093,108,3201,YX
3,2016,3222,107,3329,YX
4,2016,3275,102,3377,YX
5,2016,3345,98,3443,YX
6,2016,3485,98,3583,YX
7,2016,3494,95,3589,YX
8,2016,3652,107,3759,YX
9,2016,3661,111,3772,YX
10,2016,3938,117,4055,YX
11,2016,3898,121,4019,YX
12,2016,3896,127,4023,YX
1,2017,5420,192,5612,YX
2,2017,5412,196,5608,YX
3,2017,5385,191,5576,YX
4,2017,5354,189,5543,YX
5,2017,5423,192,5615,YX
6,2017,5427,187,5614,YX
7,2017,5469,189,5658,YX
8,2017,5526,185,5711,YX
9,2017,5556,173,5729,YX
10,2017,5606,169,5775,YX
11,2017,5540,170,5710,YX
12,2017,5555,163,5718,YX
1,2018,5328,194,5522,YX
2,2018,5513,188,5701,YX
3,2018,5486,182,5668,YX
4,2018,5531,181,5712,YX
5,2018,5602,187,5789,YX
6,2018,5620,239,5859,YX
7,2018,5692,236,5928,YX
8,2018,5701,231,5932,YX
9,2018,5720,271,5991,YX
10,2018,5762,281,6043,YX
11,2018,5760,281,6041,YX
12,2018,5767,273,6040,YX
1,2019,5776,295,6071,YX
2,2019,5751,299,6050,YX
3,2019,5744,294,6038,YX
4,2019,5869,287,6156,YX
5,2019,5925,284,6209,YX
6,2019,5831,311,6142,YX
7,2019,5885,308,6193,YX
8,2019,5877,300,6177,YX
9,2019,5973,300,6273,YX
10,2019,6038,293,6331,YX
11,2019,6071,295,6366,YX
12,2019,6070,290,6360,YX
1,2020,6103,340,6443,YX
2,2020,6164,331,6495,YX
3,2020,6195,324,6519,YX
4,2020,6018,328,6346,YX
5,2020,6003,316,6319,YX
6,2020,5955,314,6269,YX
7,2020,5801,311,6112,YX
8,2020,5757,306,6063,YX
9,2020,5708,299,6007,YX
10,2020,5535,282,5817,YX
11,2020,5511,278,5789,YX
12,2020,5480,274,5754,YX
1,2021,5397,265,5662,YX
2,2021,5329,254,5583,YX
3,2021,5307,243,5550,YX
4,2021,5245,254,5499,YX
5,2021,5326,258,5584,YX
6,2021,5496,249,5745,YX
7,2021,5647,220,5867,YX
8,2021,5716,219,5935,YX
9,2021,5804,214,6018,YX
10,2021,5819,218,6037,YX
11,2021,5928,217,6145,YX
12,2021,5862,214,6076,YX
1,2022,5955,263,6218,YX
2,2022,6024,256,6280,YX
3,2022,6004,253,6257,YX
4,2022,5949,254,6203,YX
5,2022,5996,250,6246,YX
6,2022,6107,241,6348,YX
7,2022,6072,237,6309,YX
8,2022,6011,228,6239,YX
9,2022,5931,232,6163,YX
10,2022,5904,224,6128,YX
11,2022,5846,224,6070,YX
12,2022,5737,214,5951,YX
1,2023,5719,231,5950,YX
2,2023,5667,232,5899,YX
3,2023,5623,222,5845,YX
4,2023,5495,218,5713,YX
5,2023,5470,207,5677,YX
6,2023,5443,215,5658,YX
7,2023,5391,207,5598,YX
8,2023,5325,221,5546,YX
9,2023,5327,223,5550,YX
10,2023,5373,220,5593,YX
11,2023,5345,220,5565,YX
12,2023,5276,211,5487,YX
1,2024,5310,228,5538,YX
2,2024,5304,228,5532,YX
3,2024,5285,224,5509,YX
4,2024,5320,220,5540,YX
5,2024,5382,214,5596,YX
6,2024,5455,227,5682,YX
7,2024,5550,224,5774,YX
8,2024,5625,224,5849,YX
9,2024,5707,218,5925,YX
10,2024,5707,218,5925,YX
11,2024,5839,211,6050,YX
12,2024,5831,216,6047,YX
1,2025,5882,234,6116,YX
